team,year,win,games_played,win_pct,points_scored,points_allowed,point_diff,rank,points
Air Force,2015,8,14,0.5714285714285714,473,357,116,107,106.74
Air Force,2016,10,13,0.7692307692307693,457,341,116,112,97.78
Air Force,2017,5,12,0.4166666666666667,377,389,-12,123,98.02
Air Force,2018,5,12,0.4166666666666667,362,309,53,114,110.9
Air Force,2019,11,13,0.8461538461538461,443,258,185,109,115.88
Air Force,2020,3,6,0.5,146,90,56,122,110.51
Air Force,2021,10,13,0.7692307692307693,403,257,146,107,134.5
Air Force,2022,10,13,0.7692307692307693,362,174,188,107,142.11
Air Force,2023,9,13,0.6923076923076923,362,236,126,90,144.16
Akron,2015,8,13,0.6153846153846154,311,279,32,115,97.64
Akron,2016,5,12,0.4166666666666667,329,403,-74,113,97.33
Akron,2017,7,14,0.5,310,392,-82,127,82.38
Akron,2018,4,12,0.3333333333333333,227,326,-99,132,82.29
Akron,2019,0,12,0.0,126,435,-309,131,88.91
Akron,2020,1,6,0.1666666666666666,103,248,-145,127,108.81
Akron,2021,2,12,0.1666666666666666,238,474,-236,114,130.23
Akron,2022,2,12,0.1666666666666666,261,402,-141,125,129.48
Akron,2023,2,12,0.1666666666666666,195,336,-141,119,113.25
Alabama,2015,14,15,0.9333333333333332,526,227,299,1,319.5
Alabama,2016,14,15,0.9333333333333332,582,195,387,1,319.71
Alabama,2017,13,14,0.9285714285714286,519,167,352,1,311.1
Alabama,2018,14,15,0.9333333333333332,684,271,413,1,302.04
Alabama,2019,11,13,0.8461538461538461,614,242,372,1,323.87
Alabama,2020,13,13,1.0,630,252,378,5,289.94
Alabama,2021,13,15,0.8666666666666667,598,302,296,1,317.5
Alabama,2022,11,13,0.8461538461538461,534,236,298,2,310.44
Alabama,2023,12,14,0.8571428571428571,476,266,210,1,327.91
Alabama A&M,2015,3,10,0.3,203,375,-172,186,9.99
Alabama A&M,2018,5,10,0.5,273,256,17,242,8.42
Alabama A&M,2019,7,12,0.5833333333333334,409,398,11,201,21.83
Alabama A&M,2020,5,5,1.0,163,97,66,226,7.98
Alabama A&M,2021,7,10,0.7,379,351,28,229,11.61
Alabama A&M,2023,5,11,0.4545454545454545,326,301,25,163,15.36
Alabama State,2015,5,10,0.5,235,258,-23,196,8.12
Alabama State,2016,4,11,0.3636363636363636,286,301,-15,167,20.09
Alabama State,2017,5,11,0.4545454545454545,154,198,-44,216,9.97
Alabama State,2018,3,10,0.3,143,387,-244,195,26.02
Alabama State,2020,3,6,0.5,121,121,0,194,15.57
Alabama State,2021,5,11,0.4545454545454545,240,310,-70,238,7.97
Alcorn State,2015,8,11,0.7272727272727273,441,253,188,149,26.36
Alcorn State,2017,7,12,0.5833333333333334,372,261,111,165,30.6
Alcorn State,2018,9,13,0.6923076923076923,426,279,147,196,25.55
Alcorn State,2019,9,13,0.6923076923076923,437,300,137,195,25.22
Alcorn State,2020,0,6,0.0,0,12,-12,154,38.0
Alcorn State,2021,6,11,0.5454545454545454,286,284,2,206,21.58
Alcorn State,2022,5,11,0.4545454545454545,228,274,-46,220,12.65
App State,2015,11,13,0.8461538461538461,477,248,229,125,78.64
App State,2016,10,13,0.7692307692307693,380,232,148,87,121.25
App State,2017,9,13,0.6923076923076923,435,263,172,114,112.03
App State,2018,11,13,0.8461538461538461,485,201,284,109,111.72
App State,2019,13,14,0.9285714285714286,543,280,263,107,116.78
App State,2020,9,12,0.75,406,240,166,113,120.2
App State,2021,10,14,0.7142857142857143,483,310,173,101,139.0
App State,2022,6,12,0.5,419,321,98,83,154.59
App State,2023,9,14,0.6428571428571429,465,378,87,69,161.14
Arizona,2015,7,13,0.5384615384615384,486,465,21,44,188.91
Arizona,2016,3,12,0.25,297,460,-163,31,213.29
Arizona,2017,7,13,0.5384615384615384,537,447,90,43,186.57
Arizona,2018,5,12,0.4166666666666667,376,391,-15,48,180.42
Arizona,2019,4,12,0.3333333333333333,323,429,-106,45,185.88
Arizona,2020,0,5,0.0,87,199,-112,61,178.03
Arizona,2021,1,12,0.0833333333333333,206,377,-171,54,182.67
Arizona,2022,5,12,0.4166666666666667,370,438,-68,62,170.89
Arizona,2023,10,13,0.7692307692307693,450,274,176,75,157.25
Arizona State,2015,6,13,0.4615384615384615,450,435,15,39,192.78
Arizona State,2016,5,12,0.4166666666666667,400,478,-78,23,223.19
Arizona State,2017,7,13,0.5384615384615384,414,427,-13,19,232.73
Arizona State,2018,7,13,0.5384615384615384,389,332,57,24,217.62
Arizona State,2019,8,13,0.6153846153846154,322,291,31,32,206.68
Arizona State,2020,2,4,0.5,161,93,68,36,207.26
Arizona State,2021,8,13,0.6153846153846154,369,271,98,28,219.76
Arizona State,2022,3,12,0.25,313,377,-64,24,229.47
Arizona State,2023,3,12,0.25,213,382,-169,48,185.98
Arkansas,2015,8,13,0.6153846153846154,467,356,111,23,216.6
Arkansas,2016,7,13,0.5384615384615384,394,404,-10,29,215.5
Arkansas,2017,4,12,0.3333333333333333,345,434,-89,22,222.51
Arkansas,2018,2,12,0.1666666666666666,260,417,-157,23,219.34
Arkansas,2019,2,12,0.1666666666666666,257,442,-185,27,212.74
Arkansas,2020,3,10,0.3,257,349,-92,49,192.11
Arkansas,2021,9,13,0.6923076923076923,402,298,104,23,237.17
Arkansas,2022,7,13,0.5384615384615384,423,398,25,30,212.16
Arkansas,2023,4,12,0.3333333333333333,319,335,-16,24,213.19
Arkansas State,2015,9,13,0.6923076923076923,520,393,127,100,113.75
Arkansas State,2016,8,13,0.6153846153846154,355,279,76,95,111.51
Arkansas State,2017,7,12,0.5833333333333334,454,309,145,90,131.45
Arkansas State,2018,8,13,0.6153846153846154,394,333,61,90,132.18
Arkansas State,2019,8,13,0.6153846153846154,438,444,-6,111,114.91
Arkansas State,2020,4,11,0.3636363636363636,362,409,-47,88,148.03
Arkansas State,2021,2,12,0.1666666666666666,303,463,-160,95,143.36
Arkansas State,2022,3,12,0.25,300,377,-77,92,148.75
Arkansas State,2023,6,13,0.4615384615384615,352,395,-43,106,132.61
Arkansas-Pine Bluff,2021,2,11,0.1818181818181818,218,415,-197,218,16.4
Arkansas-Pine Bluff,2022,3,11,0.2727272727272727,262,395,-133,209,16.53
Army,2015,2,12,0.1666666666666666,265,334,-69,127,74.07
Army,2016,8,13,0.6153846153846154,389,258,131,121,87.22
Army,2017,10,13,0.7692307692307693,399,286,113,120,100.83
Army,2018,11,13,0.8461538461538461,426,230,196,117,108.9
Army,2019,5,13,0.3846153846153846,370,299,71,120,106.37
Army,2020,9,12,0.75,321,178,143,117,118.69
Army,2021,9,13,0.6923076923076923,427,290,137,99,139.75
Army,2022,6,12,0.5,343,270,73,111,139.43
Army,2023,6,12,0.5,246,253,-7,109,131.27
Auburn,2015,7,13,0.5384615384615384,357,338,19,10,267.46
Auburn,2016,8,13,0.6153846153846154,406,222,184,6,277.12
Auburn,2017,10,14,0.7142857142857143,474,259,215,8,278.31
Auburn,2018,8,13,0.6153846153846154,402,249,153,9,275.14
Auburn,2019,9,13,0.6923076923076923,432,254,178,9,255.92
Auburn,2020,6,11,0.5454545454545454,276,272,4,12,262.77
Auburn,2021,6,13,0.4615384615384615,368,283,85,11,271.94
Auburn,2022,5,12,0.4166666666666667,297,354,-57,7,274.6
Auburn,2023,6,13,0.4615384615384615,340,294,46,30,205.63
Austin Peay,2015,0,11,0.0,133,429,-296,163,21.02
Austin Peay,2016,0,11,0.0,259,517,-258,156,25.04
Austin Peay,2017,8,12,0.6666666666666666,327,297,30,153,35.12
Austin Peay,2018,5,11,0.4545454545454545,340,337,3,144,67.88
Austin Peay,2019,11,15,0.7333333333333333,518,309,209,132,88.84
Austin Peay,2020,4,9,0.4444444444444444,215,301,-86,133,88.36
Austin Peay,2021,6,11,0.5454545454545454,358,274,84,165,46.22
Austin Peay,2022,7,11,0.6363636363636364,347,250,97,204,17.16
Austin Peay,2023,9,12,0.75,402,284,118,155,24.23
BYU,2015,9,13,0.6923076923076923,438,297,141,66,152.55
BYU,2016,9,13,0.6923076923076923,384,254,130,64,161.71
BYU,2017,4,13,0.3076923076923077,222,321,-99,65,165.06
BYU,2018,7,13,0.5384615384615384,354,278,76,49,177.85
BYU,2019,7,13,0.5384615384615384,370,331,39,66,167.37
BYU,2020,11,12,0.9166666666666666,522,184,338,78,160.52
BYU,2021,10,13,0.7692307692307693,430,322,108,81,156.76
BYU,2022,8,13,0.6153846153846154,407,383,24,78,159.91
BYU,2023,5,12,0.4166666666666667,277,358,-81,71,159.77
Ball State,2015,3,12,0.25,277,430,-153,105,107.69
Ball State,2016,4,12,0.3333333333333333,324,361,-37,101,107.53
Ball State,2017,2,12,0.1666666666666666,215,488,-273,105,119.7
Ball State,2018,4,12,0.3333333333333333,290,389,-99,113,110.91
Ball State,2019,5,12,0.4166666666666667,418,377,41,90,128.8
Ball State,2020,7,8,0.875,274,206,68,119,115.57
Ball State,2021,6,13,0.4615384615384615,313,369,-56,125,122.89
Ball State,2022,5,12,0.4166666666666667,279,323,-44,122,131.5
Ball State,2023,4,12,0.3333333333333333,219,293,-74,95,140.07
Baylor,2015,10,13,0.7692307692307693,625,368,257,27,209.23
Baylor,2016,7,13,0.5384615384615384,450,377,73,25,218.13
Baylor,2017,1,12,0.0833333333333333,292,431,-139,36,195.88
Baylor,2018,7,13,0.5384615384615384,384,412,-28,40,191.99
Baylor,2019,11,14,0.7857142857142857,471,277,194,40,193.36
Baylor,2020,2,9,0.2222222222222222,210,263,-53,29,215.02
Baylor,2021,12,14,0.8571428571428571,443,256,187,35,203.39
Baylor,2022,6,13,0.4615384615384615,418,349,69,54,181.12
Baylor,2023,3,12,0.25,277,400,-123,44,190.18
Bethune-Cookman,2015,9,11,0.8181818181818182,345,275,70,155,23.74
Bethune-Cookman,2016,4,10,0.4,252,252,0,163,20.62
Bethune-Cookman,2017,7,11,0.6363636363636364,228,263,-35,170,26.73
Bethune-Cookman,2018,7,12,0.5833333333333334,359,365,-6,155,56.07
Bethune-Cookman,2019,7,11,0.6363636363636364,268,285,-17,235,7.76
Bethune-Cookman,2021,2,11,0.1818181818181818,270,399,-129,230,11.54
Boise State,2015,9,13,0.6923076923076923,508,263,245,55,173.51
Boise State,2016,10,13,0.7692307692307693,439,303,136,63,163.09
Boise State,2017,11,14,0.7857142857142857,455,320,135,58,171.68
Boise State,2018,10,13,0.7692307692307693,460,287,173,68,160.66
Boise State,2019,12,14,0.8571428571428571,486,306,180,64,167.43
Boise State,2020,5,7,0.7142857142857143,237,190,47,57,183.46
Boise State,2021,7,12,0.5833333333333334,350,228,122,50,189.93
Boise State,2022,10,14,0.7142857142857143,413,273,140,65,167.92
Boise State,2023,8,14,0.5714285714285714,450,358,92,70,161.13
Boston College,2015,3,12,0.25,206,183,23,86,126.19
Boston College,2016,7,13,0.5384615384615384,265,325,-60,51,177.12
Boston College,2017,7,13,0.5384615384615384,334,297,37,60,169.45
Boston College,2018,7,12,0.5833333333333334,384,308,76,78,146.69
Boston College,2019,6,13,0.4615384615384615,377,418,-41,67,162.61
Boston College,2020,6,11,0.5454545454545454,306,312,-6,71,172.47
Boston College,2021,6,12,0.5,296,266,30,63,177.26
Boston College,2022,3,12,0.25,213,364,-151,63,170.36
Boston College,2023,7,13,0.5384615384615384,323,368,-45,36,201.66
Bowling Green,2015,10,14,0.7142857142857143,591,405,186,85,131.36
Bowling Green,2016,4,12,0.3333333333333333,298,460,-162,106,102.64
Bowling Green,2017,2,12,0.1666666666666666,304,456,-152,104,119.83
Bowling Green,2018,3,12,0.25,292,480,-188,111,111.58
Bowling Green,2019,3,12,0.25,192,463,-271,81,138.14
Bowling Green,2020,0,5,0.0,57,225,-168,91,144.03
Bowling Green,2021,4,12,0.3333333333333333,257,368,-111,129,115.37
Bowling Green,2022,6,13,0.4615384615384615,305,423,-118,85,154.4
Bowling Green,2023,7,13,0.5384615384615384,340,312,28,103,133.73
Brown,2015,5,10,0.5,279,329,-50,181,11.99
Brown,2018,1,10,0.1,143,362,-219,236,10.69
Brown,2019,2,10,0.2,300,402,-102,174,37.71
Brown,2022,3,10,0.3,231,351,-120,180,28.57
Brown,2023,5,10,0.5,255,290,-35,162,15.57
Bryant,2022,4,11,0.3636363636363636,366,331,35,232,8.98
Bucknell,2015,4,11,0.3636363636363636,172,206,-34,199,7.79
Bucknell,2016,4,11,0.3636363636363636,232,263,-31,235,6.31
Bucknell,2017,5,11,0.4545454545454545,185,249,-64,207,11.95
Bucknell,2018,1,11,0.0909090909090909,147,311,-164,210,19.13
Bucknell,2021,1,11,0.0909090909090909,104,417,-313,222,14.96
Bucknell,2022,3,11,0.2727272727272727,141,312,-171,201,19.97
Buffalo,2015,5,12,0.4166666666666667,320,331,-11,128,72.53
Buffalo,2016,2,12,0.1666666666666666,198,388,-190,100,108.06
Buffalo,2017,6,12,0.5,342,298,44,118,103.21
Buffalo,2018,10,14,0.7142857142857143,484,363,121,118,107.51
Buffalo,2019,8,13,0.6153846153846154,409,277,132,113,112.97
Buffalo,2020,6,7,0.8571428571428571,304,153,151,136,81.31
Buffalo,2021,4,12,0.3333333333333333,351,359,-8,106,134.64
Buffalo,2022,7,13,0.5384615384615384,371,347,24,130,114.94
Buffalo,2023,3,12,0.25,251,329,-78,98,137.78
Butler,2016,4,11,0.3636363636363636,270,318,-48,287,-0.03
Butler,2017,6,11,0.5454545454545454,294,275,19,230,6.67
Butler,2020,0,6,0.0,91,175,-84,207,11.15
Cal Poly,2016,7,12,0.5833333333333334,416,394,22,229,6.67
Cal Poly,2017,1,11,0.0909090909090909,203,352,-149,155,34.98
Cal Poly,2018,5,11,0.4545454545454545,315,400,-85,189,29.43
Cal Poly,2019,3,11,0.2727272727272727,277,375,-98,213,14.46
Cal Poly,2020,0,3,0.0,58,169,-111,233,5.97
Cal Poly,2021,2,11,0.1818181818181818,169,431,-262,179,34.79
Cal Poly,2022,2,11,0.1818181818181818,241,467,-226,135,94.88
Cal Poly,2023,3,11,0.2727272727272727,226,434,-208,131,62.42
California,2015,8,13,0.6153846153846154,493,399,94,41,190.85
California,2016,5,12,0.4166666666666667,445,511,-66,55,174.52
California,2017,5,12,0.4166666666666667,333,341,-8,34,198.77
California,2018,7,13,0.5384615384615384,280,258,22,31,207.8
California,2019,8,13,0.6153846153846154,276,285,-9,70,159.53
California,2020,1,4,0.25,81,106,-25,42,197.41
California,2021,5,12,0.4166666666666667,285,267,18,43,196.48
California,2022,4,12,0.3333333333333333,287,334,-47,39,198.0
California,2023,6,13,0.4615384615384615,393,426,-33,28,209.2
Campbell,2016,5,10,0.5,281,244,37,236,5.95
Campbell,2018,6,11,0.5454545454545454,273,242,31,244,6.67
Campbell,2019,6,11,0.5454545454545454,325,341,-16,222,11.39
Campbell,2020,0,4,0.0,82,188,-106,185,17.51
Campbell,2022,5,11,0.4545454545454545,341,311,30,228,10.98
Campbell,2023,5,11,0.4545454545454545,316,366,-50,192,6.8
Central Arkansas,2015,6,10,0.6,268,263,5,145,28.88
Central Arkansas,2016,10,13,0.7692307692307693,430,282,148,182,15.73
Central Arkansas,2017,10,12,0.8333333333333334,429,210,219,184,21.06
Central Arkansas,2018,6,11,0.5454545454545454,336,287,49,148,62.3
Central Arkansas,2019,9,13,0.6923076923076923,361,346,15,236,7.63
Central Arkansas,2020,5,9,0.5555555555555556,291,261,30,155,37.36
Central Arkansas,2021,5,11,0.4545454545454545,379,316,63,136,106.84
Central Arkansas,2022,5,11,0.4545454545454545,353,351,2,150,61.89
Central Arkansas,2023,7,11,0.6363636363636364,337,246,91,146,30.3
Central Connecticut,2018,6,11,0.5454545454545454,372,280,92,256,6.67
Central Michigan,2015,7,13,0.5384615384615384,336,286,50,104,108.05
Central Michigan,2016,6,13,0.4615384615384615,342,394,-52,116,91.2
Central Michigan,2017,8,13,0.6153846153846154,370,358,12,97,123.63
Central Michigan,2018,1,12,0.0833333333333333,180,328,-148,107,112.52
Central Michigan,2019,8,14,0.5714285714285714,426,396,30,93,127.4
Central Michigan,2020,3,6,0.5,188,181,7,120,111.22
Central Michigan,2021,9,13,0.6923076923076923,420,335,85,104,137.96
Central Michigan,2022,4,12,0.3333333333333333,297,338,-41,123,130.86
Central Michigan,2023,5,12,0.4166666666666667,278,373,-95,87,146.12
Charleston Southern,2016,7,11,0.6363636363636364,363,244,119,135,48.6
Charleston Southern,2017,6,11,0.5454545454545454,250,218,32,209,11.13
Charleston Southern,2018,5,11,0.4545454545454545,233,259,-26,201,24.29
Charleston Southern,2019,6,12,0.5,267,371,-104,210,15.53
Charleston Southern,2020,2,4,0.5,83,80,3,196,15.0
Charleston Southern,2021,4,10,0.4,245,289,-44,235,9.03
Charleston Southern,2023,4,11,0.3636363636363636,176,321,-145,158,19.5
Charlotte,2015,2,12,0.1666666666666666,210,435,-225,112,100.75
Charlotte,2016,4,12,0.3333333333333333,302,415,-113,119,89.2
Charlotte,2017,1,12,0.0833333333333333,170,393,-223,126,86.91
Charlotte,2018,5,12,0.4166666666666667,260,319,-59,119,106.83
Charlotte,2019,7,13,0.5384615384615384,388,421,-33,114,111.82
Charlotte,2020,2,6,0.3333333333333333,162,195,-33,111,120.43
Charlotte,2021,5,12,0.4166666666666667,326,408,-82,132,112.69
Charlotte,2022,3,12,0.25,293,473,-180,88,152.55
Charlotte,2023,3,12,0.25,210,343,-133,101,134.83
Chattanooga,2015,9,13,0.6923076923076923,384,291,93,138,34.29
Chattanooga,2016,9,13,0.6923076923076923,445,255,190,131,69.28
Chattanooga,2017,3,11,0.2727272727272727,195,284,-89,131,63.37
Chattanooga,2018,6,11,0.5454545454545454,236,231,5,183,34.03
Chattanooga,2019,6,12,0.5,315,360,-45,151,60.61
Chattanooga,2020,3,5,0.6,107,103,4,139,80.04
Chattanooga,2021,6,11,0.5454545454545454,293,188,105,178,34.93
Chattanooga,2023,8,13,0.6153846153846154,357,319,38,175,12.15
Cincinnati,2015,7,13,0.5384615384615384,440,405,35,60,162.33
Cincinnati,2016,4,12,0.3333333333333333,232,323,-91,65,161.43
Cincinnati,2017,4,12,0.3333333333333333,251,382,-131,68,162.45
Cincinnati,2018,11,13,0.8461538461538461,454,224,230,74,152.74
Cincinnati,2019,11,14,0.7857142857142857,415,288,127,63,167.8
Cincinnati,2020,9,10,0.9,375,168,207,48,192.64
Cincinnati,2021,13,14,0.9285714285714286,516,236,280,79,158.17
Cincinnati,2022,9,13,0.6923076923076923,380,268,112,40,194.95
Cincinnati,2023,3,12,0.25,289,360,-71,42,190.66
Clemson,2015,14,15,0.9333333333333332,577,325,252,15,249.66
Clemson,2016,14,15,0.9333333333333332,588,270,318,16,240.73
Clemson,2017,12,14,0.8571428571428571,466,190,276,9,277.98
Clemson,2018,15,15,1.0,664,197,467,11,271.16
Clemson,2019,14,15,0.9333333333333332,659,203,456,16,238.91
Clemson,2020,10,12,0.8333333333333334,522,242,280,7,283.67
Clemson,2021,10,13,0.7692307692307693,342,193,149,10,275.55
Clemson,2022,11,14,0.7857142857142857,465,292,173,3,309.73
Clemson,2023,9,13,0.6923076923076923,388,274,114,5,291.2
Coastal Carolina,2015,9,12,0.75,421,241,180,137,35.72
Coastal Carolina,2016,10,12,0.8333333333333334,447,232,215,168,19.95
Coastal Carolina,2017,3,12,0.25,284,408,-124,171,26.71
Coastal Carolina,2018,5,12,0.4166666666666667,320,398,-78,126,97.11
Coastal Carolina,2019,5,12,0.4166666666666667,364,366,-2,126,96.51
Coastal Carolina,2020,11,12,0.9166666666666666,446,243,203,114,120.13
Coastal Carolina,2021,11,13,0.8461538461538461,532,281,251,122,125.06
Coastal Carolina,2022,9,13,0.6923076923076923,378,414,-36,116,136.61
Coastal Carolina,2023,8,13,0.6153846153846154,360,310,50,84,150.67
Colgate,2015,9,14,0.6428571428571429,356,401,-45,189,9.83
Colgate,2016,5,10,0.5,311,234,77,195,13.26
Colgate,2017,7,11,0.6363636363636364,305,192,113,173,26.17
Colgate,2018,10,12,0.8333333333333334,324,112,212,221,15.51
Colgate,2019,4,12,0.3333333333333333,178,324,-146,227,10.05
Colgate,2020,0,2,0.0,18,64,-46,229,6.98
Colgate,2021,5,11,0.4545454545454545,206,287,-81,226,13.03
Colgate,2022,3,11,0.2727272727272727,237,335,-98,245,4.97
Colorado,2015,4,13,0.3076923076923077,320,357,-37,68,151.29
Colorado,2016,10,14,0.7142857142857143,435,304,131,74,147.9
Colorado,2017,5,12,0.4166666666666667,317,338,-21,69,162.04
Colorado,2018,5,12,0.4166666666666667,325,327,-2,69,160.42
Colorado,2019,5,12,0.4166666666666667,282,382,-100,35,203.78
Colorado,2020,4,6,0.6666666666666666,171,190,-19,53,187.11
Colorado,2021,4,12,0.3333333333333333,225,320,-95,44,194.55
Colorado,2022,1,12,0.0833333333333333,185,534,-349,36,203.17
Colorado,2023,4,12,0.3333333333333333,338,418,-80,65,167.11
Colorado State,2015,7,13,0.5384615384615384,385,354,31,84,132.61
Colorado State,2016,7,13,0.5384615384615384,459,395,64,86,122.77
Colorado State,2017,7,13,0.5384615384615384,434,361,73,119,101.72
Colorado State,2018,3,12,0.25,274,441,-167,76,150.5
Colorado State,2019,4,12,0.3333333333333333,337,374,-37,73,158.09
Colorado State,2020,1,4,0.25,89,143,-54,86,152.79
Colorado State,2021,3,12,0.25,284,339,-55,84,155.22
Colorado State,2022,3,12,0.25,158,323,-165,102,142.8
Colorado State,2023,5,12,0.4166666666666667,313,355,-42,89,144.67
Columbia,2015,2,10,0.2,143,198,-55,184,10.79
Columbia,2016,3,10,0.3,185,247,-62,230,6.67
Columbia,2017,8,10,0.8,239,175,64,219,9.46
Columbia,2018,6,10,0.6,231,252,-21,130,90.67
Columbia,2019,3,10,0.3,193,286,-93,167,43.63
Columbia,2022,6,10,0.6,265,208,57,149,62.05
Columbia,2023,3,10,0.3,149,182,-33,159,18.29
Cornell,2016,4,10,0.4,230,310,-80,218,8.82
Cornell,2017,3,10,0.3,173,243,-70,198,13.69
Cornell,2018,3,10,0.3,191,297,-106,232,12.21
Cornell,2019,4,10,0.4,206,207,-1,181,32.15
Cornell,2022,5,10,0.5,216,283,-67,211,15.89
Dartmouth,2015,9,10,0.9,288,101,187,213,3.31
Dartmouth,2017,8,10,0.8,274,200,74,172,26.36
Dartmouth,2018,9,10,0.9,340,120,220,172,42.51
Dartmouth,2019,9,10,0.9,333,124,209,177,35.05
Dartmouth,2021,9,10,0.9,306,147,159,160,54.85
Dartmouth,2022,3,10,0.3,201,205,-4,148,64.97
Davidson,2022,8,12,0.6666666666666666,383,292,91,172,34.64
Dayton,2019,8,11,0.7272727272727273,468,382,86,224,10.68
Delaware,2015,4,11,0.3636363636363636,164,225,-61,147,28.63
Delaware,2016,4,11,0.3636363636363636,242,276,-34,165,20.34
Delaware,2017,7,11,0.6363636363636364,233,185,48,162,32.38
Delaware,2018,7,12,0.5833333333333334,293,258,35,184,32.74
Delaware,2019,5,12,0.4166666666666667,278,344,-66,152,58.54
Delaware,2020,7,8,0.875,206,115,91,225,7.98
Delaware,2021,5,11,0.4545454545454545,217,257,-40,176,35.61
Delaware,2022,8,13,0.6153846153846154,366,237,129,199,20.1
Delaware State,2016,0,11,0.0,162,437,-275,212,9.86
Delaware State,2017,2,11,0.1818181818181818,158,420,-262,236,4.98
Delaware State,2018,3,11,0.2727272727272727,184,369,-185,209,19.92
Delaware State,2019,2,12,0.1666666666666666,235,369,-134,221,11.65
Drake,2018,7,11,0.6363636363636364,326,210,116,259,5.31
Drake,2020,2,5,0.4,91,64,27,245,0.97
Duke,2015,8,13,0.6153846153846154,410,330,80,71,148.96
Duke,2016,4,12,0.3333333333333333,280,338,-58,61,166.35
Duke,2017,7,13,0.5384615384615384,345,263,82,52,175.77
Duke,2018,8,13,0.6153846153846154,382,356,26,33,204.67
Duke,2019,5,12,0.4166666666666667,303,350,-47,47,184.46
Duke,2020,2,11,0.1818181818181818,273,419,-146,63,176.85
Duke,2021,3,12,0.25,274,477,-203,49,191.38
Duke,2022,9,13,0.6923076923076923,427,287,140,61,171.72
Duke,2023,8,13,0.6153846153846154,350,247,103,58,176.16
Duquesne,2015,8,12,0.6666666666666666,368,231,137,150,25.58
Duquesne,2016,8,11,0.7272727272727273,343,273,70,221,8.32
Duquesne,2017,7,11,0.6363636363636364,354,262,92,161,32.39
Duquesne,2020,4,4,1.0,102,54,48,191,16.59
Duquesne,2021,7,10,0.7,295,229,66,240,7.52
Duquesne,2023,7,12,0.5833333333333334,325,361,-36,176,12.14
East Carolina,2015,5,12,0.4166666666666667,329,312,17,73,146.66
East Carolina,2016,3,12,0.25,324,433,-109,76,136.87
East Carolina,2017,3,12,0.25,299,540,-241,93,126.85
East Carolina,2018,3,12,0.25,273,448,-175,79,146.62
East Carolina,2019,4,12,0.3333333333333333,321,404,-83,79,144.55
East Carolina,2020,3,9,0.3333333333333333,272,319,-47,89,147.43
East Carolina,2021,7,12,0.5833333333333334,356,315,41,78,158.4
East Carolina,2022,8,13,0.6153846153846154,423,353,70,70,163.06
East Carolina,2023,2,12,0.1666666666666666,208,269,-61,96,139.28
East Tennessee State,2016,5,11,0.4545454545454545,174,308,-134,159,23.78
East Tennessee State,2017,4,11,0.3636363636363636,211,313,-102,164,31.28
East Tennessee State,2019,3,12,0.25,241,314,-73,190,27.81
East Tennessee State,2020,4,6,0.6666666666666666,126,113,13,219,8.53
East Tennessee State,2021,11,13,0.8461538461538461,425,295,130,184,32.91
East Tennessee State,2022,3,11,0.2727272727272727,323,336,-13,168,35.94
Eastern Illinois,2016,6,11,0.5454545454545454,294,310,-16,158,24.03
Eastern Illinois,2018,3,11,0.2727272727272727,357,445,-88,199,25.15
Eastern Illinois,2019,1,12,0.0833333333333333,177,364,-187,242,6.67
Eastern Illinois,2020,1,6,0.1666666666666666,120,201,-81,240,3.97
Eastern Illinois,2021,1,11,0.0909090909090909,160,312,-152,173,37.39
Eastern Illinois,2022,2,11,0.1818181818181818,245,343,-98,159,42.77
Eastern Kentucky,2016,3,11,0.2727272727272727,287,336,-49,196,13.24
Eastern Kentucky,2017,4,11,0.3636363636363636,228,292,-64,211,11.01
Eastern Kentucky,2018,7,11,0.6363636363636364,296,316,-20,154,56.1
Eastern Kentucky,2019,7,12,0.5833333333333334,335,264,71,142,73.32
Eastern Kentucky,2020,3,9,0.3333333333333333,217,299,-82,141,73.04
Eastern Kentucky,2021,7,11,0.6363636363636364,304,275,29,140,90.32
Eastern Kentucky,2022,7,12,0.5833333333333334,434,422,12,151,60.5
Eastern Michigan,2015,1,12,0.0833333333333333,305,505,-200,113,98.58
Eastern Michigan,2016,7,13,0.5384615384615384,385,388,-3,124,84.89
Eastern Michigan,2017,5,12,0.4166666666666667,313,280,33,115,110.15
Eastern Michigan,2018,7,13,0.5384615384615384,351,287,64,121,102.89
Eastern Michigan,2019,6,13,0.4615384615384615,379,398,-19,123,100.97
Eastern Michigan,2020,2,6,0.3333333333333333,199,216,-17,110,121.54
Eastern Michigan,2021,7,13,0.5384615384615384,392,390,2,123,124.99
Eastern Michigan,2022,9,13,0.6923076923076923,387,370,17,115,136.77
Eastern Michigan,2023,6,13,0.4615384615384615,254,347,-93,112,128.54
Eastern Washington,2015,6,11,0.5454545454545454,381,435,-54,154,23.93
Eastern Washington,2016,12,14,0.8571428571428571,593,371,222,179,16.52
Eastern Washington,2017,7,11,0.6363636363636364,379,367,12,179,22.02
Eastern Washington,2018,12,15,0.8,647,340,307,145,64.63
Eastern Washington,2019,7,12,0.5833333333333334,487,415,72,130,92.82
Eastern Washington,2020,5,7,0.7142857142857143,264,188,76,140,75.03
Eastern Washington,2021,10,13,0.7692307692307693,572,362,210,138,94.76
Eastern Washington,2022,3,11,0.2727272727272727,271,466,-195,128,117.96
Eastern Washington,2023,4,11,0.3636363636363636,355,397,-42,138,48.13
Elon,2015,4,11,0.3636363636363636,147,273,-126,214,1.97
Elon,2016,2,11,0.1818181818181818,134,338,-204,231,6.67
Elon,2017,8,12,0.6666666666666666,256,298,-42,210,11.06
Elon,2018,6,11,0.5454545454545454,268,260,8,219,15.61
Elon,2019,5,11,0.4545454545454545,276,297,-21,245,6.67
Elon,2020,1,6,0.1666666666666666,104,185,-81,206,11.15
Elon,2021,6,11,0.5454545454545454,265,287,-22,220,16.08
Elon,2022,8,12,0.6666666666666666,309,256,53,166,36.99
Florida,2015,10,14,0.7142857142857143,325,256,69,3,291.89
Florida,2016,9,13,0.6923076923076923,311,218,93,9,267.4
Florida,2017,4,11,0.3636363636363636,243,300,-57,21,227.46
Florida,2018,10,13,0.7692307692307693,455,260,195,12,260.96
Florida,2019,11,13,0.8461538461538461,432,201,231,11,251.23
Florida,2020,8,12,0.6666666666666666,478,370,108,14,259.56
Florida,2021,6,13,0.4615384615384615,399,348,51,9,276.85
Florida,2022,6,13,0.4615384615384615,384,375,9,8,272.99
Florida,2023,5,12,0.4166666666666667,341,331,10,13,261.62
Florida A&M,2015,1,11,0.0909090909090909,161,369,-208,172,15.66
Florida A&M,2016,4,11,0.3636363636363636,206,361,-155,295,-0.03
Florida A&M,2017,3,11,0.2727272727272727,242,309,-67,159,32.93
Florida A&M,2018,6,11,0.5454545454545454,290,243,47,147,63.31
Florida A&M,2019,9,11,0.8181818181818182,360,301,59,206,18.09
Florida A&M,2021,9,12,0.75,333,204,129,234,9.93
Florida Atlantic,2015,3,12,0.25,270,345,-75,96,119.58
Florida Atlantic,2016,3,12,0.25,317,477,-160,94,111.77
Florida Atlantic,2017,11,14,0.7857142857142857,568,318,250,79,146.02
Florida Atlantic,2018,5,12,0.4166666666666667,373,380,-7,89,132.74
Florida Atlantic,2019,11,14,0.7857142857142857,510,318,192,60,171.18
Florida Atlantic,2020,5,9,0.5555555555555556,170,157,13,75,163.9
Florida Atlantic,2021,5,12,0.4166666666666667,305,309,-4,60,178.99
Florida Atlantic,2022,5,12,0.4166666666666667,357,319,38,73,162.51
Florida Atlantic,2023,4,12,0.3333333333333333,285,306,-21,82,153.21
Florida International,2015,5,12,0.4166666666666667,306,358,-52,114,98.08
Florida International,2016,4,12,0.3333333333333333,288,418,-130,109,100.66
Florida International,2017,8,13,0.6153846153846154,333,370,-37,100,120.42
Florida International,2018,9,13,0.6923076923076923,450,328,122,104,119.8
Florida International,2019,6,13,0.4615384615384615,344,354,-10,83,137.75
Florida International,2020,0,5,0.0,112,162,-50,69,173.58
Florida International,2021,1,12,0.0833333333333333,244,476,-232,88,152.57
Florida International,2022,4,12,0.3333333333333333,224,447,-223,74,162.27
Florida International,2023,4,12,0.3333333333333333,241,382,-141,83,152.13
Florida State,2015,10,13,0.7692307692307693,412,227,185,11,262.69
Florida State,2016,10,13,0.7692307692307693,456,325,131,4,286.79
Florida State,2017,7,13,0.5384615384615384,362,276,86,3,287.06
Florida State,2018,5,12,0.4166666666666667,263,378,-115,3,294.83
Florida State,2019,6,13,0.4615384615384615,363,362,1,6,292.88
Florida State,2020,3,9,0.3333333333333333,232,324,-92,11,265.42
Florida State,2021,5,12,0.4166666666666667,331,318,13,19,244.31
Florida State,2022,10,13,0.7692307692307693,469,268,201,22,238.41
Florida State,2023,13,14,0.9285714285714286,484,270,214,22,214.97
Fordham,2015,9,12,0.75,442,367,75,195,8.51
Fordham,2016,8,11,0.7272727272727273,441,331,110,171,18.92
Fordham,2017,4,11,0.3636363636363636,239,384,-145,235,5.0
Fordham,2018,2,11,0.1818181818181818,174,310,-136,211,19.12
Fordham,2019,4,12,0.3333333333333333,300,388,-88,196,24.95
Fordham,2020,2,3,0.6666666666666666,95,59,36,168,27.25
Fordham,2021,6,11,0.5454545454545454,370,351,19,186,32.49
Fordham,2022,9,12,0.75,594,434,160,195,21.45
Fordham,2023,6,11,0.5454545454545454,335,272,63,187,8.69
Fresno State,2015,3,12,0.25,267,457,-190,75,142.76
Fresno State,2016,1,12,0.0833333333333333,212,371,-159,84,124.42
Fresno State,2017,10,14,0.7142857142857143,380,251,129,72,155.02
Fresno State,2018,12,14,0.8571428571428571,485,198,287,85,137.22
Fresno State,2019,4,12,0.3333333333333333,360,361,-1,84,137.74
Fresno State,2020,3,6,0.5,197,180,17,92,141.73
Fresno State,2021,10,13,0.7692307692307693,434,267,167,87,153.5
Fresno State,2022,10,14,0.7142857142857143,428,272,156,121,131.51
Fresno State,2023,9,13,0.6923076923076923,396,305,91,74,159.11
Furman,2015,4,11,0.3636363636363636,193,318,-125,136,37.08
Furman,2016,3,11,0.2727272727272727,301,298,3,148,30.83
Furman,2017,8,13,0.6153846153846154,424,311,113,160,32.92
Furman,2018,6,10,0.6,272,282,-10,170,45.22
Furman,2019,8,13,0.6153846153846154,435,267,168,219,12.6
Furman,2020,3,7,0.4285714285714285,148,143,5,158,34.46
Furman,2021,6,11,0.5454545454545454,267,259,8,180,34.69
Furman,2022,10,13,0.7692307692307693,430,263,167,158,43.15
Gardner-Webb,2015,4,11,0.3636363636363636,141,227,-86,210,5.98
Gardner-Webb,2017,1,11,0.0909090909090909,177,311,-134,189,16.8
Gardner-Webb,2018,3,11,0.2727272727272727,221,407,-186,190,29.25
Gardner-Webb,2019,3,12,0.25,287,434,-147,257,1.97
Gardner-Webb,2020,2,4,0.5,99,112,-13,177,23.2
Gardner-Webb,2021,4,11,0.3636363636363636,326,335,-9,241,6.3
Gardner-Webb,2023,7,12,0.5833333333333334,322,337,-15,185,8.92
Georgetown,2015,4,11,0.3636363636363636,222,296,-74,217,0.0
Georgetown,2016,3,11,0.2727272727272727,166,256,-90,216,8.93
Georgetown,2017,1,11,0.0909090909090909,138,299,-161,229,6.92
Georgetown,2018,5,11,0.4545454545454545,172,232,-60,208,19.96
Georgetown,2021,2,10,0.2,190,306,-116,166,45.58
Georgetown,2022,2,11,0.1818181818181818,249,401,-152,163,40.93
Georgetown,2023,5,11,0.4545454545454545,283,284,-1,147,29.42
Georgia,2015,10,13,0.7692307692307693,342,220,122,12,260.38
Georgia,2016,8,13,0.6153846153846154,319,312,7,8,273.39
Georgia,2017,13,15,0.8666666666666667,531,246,285,6,282.54
Georgia,2018,11,14,0.7857142857142857,530,269,261,6,281.31
Georgia,2019,12,14,0.8571428571428571,431,176,255,3,301.6
Georgia,2020,8,10,0.8,323,200,123,1,323.31
Georgia,2021,14,15,0.9333333333333332,579,153,426,2,309.12
Georgia,2022,15,15,1.0,616,214,402,1,313.34
Georgia,2023,13,14,0.9285714285714286,562,219,343,3,294.55
Georgia Southern,2015,9,13,0.6923076923076923,474,306,168,135,40.99
Georgia Southern,2016,5,12,0.4166666666666667,319,318,1,96,111.25
Georgia Southern,2017,2,12,0.1666666666666666,250,386,-136,85,137.18
Georgia Southern,2018,10,13,0.7692307692307693,396,280,116,77,149.4
Georgia Southern,2019,7,13,0.5384615384615384,366,366,0,106,118.78
Georgia Southern,2020,8,13,0.6153846153846154,354,270,84,90,146.64
Georgia Southern,2021,3,12,0.25,243,377,-134,121,125.24
Georgia Southern,2022,6,13,0.4615384615384615,425,411,14,98,145.22
Georgia Southern,2023,6,13,0.4615384615384615,392,396,-4,92,141.76
Georgia State,2015,6,13,0.4615384615384615,350,368,-18,111,101.05
Georgia State,2016,3,12,0.25,239,319,-80,105,102.91
Georgia State,2017,7,12,0.5833333333333334,244,297,-53,124,90.61
Georgia State,2018,2,12,0.1666666666666666,286,449,-163,127,96.32
Georgia State,2019,7,13,0.5384615384615384,406,471,-65,105,119.23
Georgia State,2020,6,10,0.6,333,317,16,95,140.45
Georgia State,2021,8,13,0.6153846153846154,366,352,14,98,140.37
Georgia State,2022,4,12,0.3333333333333333,360,374,-14,110,140.52
Georgia State,2023,7,13,0.5384615384615384,354,391,-37,102,134.55
Georgia Tech,2015,3,12,0.25,351,309,42,70,149.34
Georgia Tech,2016,9,13,0.6923076923076923,367,318,49,54,175.71
Georgia Tech,2017,5,11,0.4545454545454545,309,292,17,44,185.45
Georgia Tech,2018,7,13,0.5384615384615384,437,381,56,60,167.13
Georgia Tech,2019,3,12,0.25,200,389,-189,48,184.4
Georgia Tech,2020,3,10,0.3,239,368,-129,44,196.94
Georgia Tech,2021,3,12,0.25,288,402,-114,51,188.28
Georgia Tech,2022,5,12,0.4166666666666667,206,341,-135,26,222.73
Georgia Tech,2023,7,13,0.5384615384615384,404,383,21,47,186.82
Grambling,2015,7,10,0.7,391,312,79,205,6.67
Grambling,2016,12,13,0.9230769230769232,549,205,344,197,13.18
Grambling,2020,0,4,0.0,66,147,-81,149,44.91
Grambling,2021,4,11,0.3636363636363636,189,304,-115,232,10.64
Grambling,2022,3,11,0.2727272727272727,249,363,-114,193,22.25
Grambling,2023,5,11,0.4545454545454545,316,314,2,154,24.49
Grand Valley State University,2021,10,12,0.8333333333333334,456,223,233,169,41.63
Hampton,2016,5,11,0.4545454545454545,213,269,-56,214,9.04
Hampton,2017,6,11,0.5454545454545454,236,243,-7,204,12.87
Hampton,2018,6,9,0.6666666666666666,301,266,35,218,15.61
Hampton,2021,5,11,0.4545454545454545,308,347,-39,231,11.0
Hampton,2022,4,11,0.3636363636363636,220,298,-78,190,22.89
Harvard,2015,9,10,0.9,364,130,234,130,51.51
Harvard,2016,7,10,0.7,262,210,52,140,41.25
Harvard,2017,5,10,0.5,220,209,11,129,67.37
Harvard,2018,6,10,0.6,304,218,86,139,74.84
Harvard,2019,4,10,0.4,296,228,68,125,99.16
Harvard,2021,8,10,0.8,324,149,175,127,121.09
Harvard,2022,6,10,0.6,269,236,33,140,77.67
Harvard,2023,8,10,0.8,318,202,116,129,70.08
Hawai'i,2015,3,13,0.2307692307692307,229,463,-234,78,139.5
Hawai'i,2016,7,14,0.5,396,522,-126,99,108.34
Hawai'i,2017,3,12,0.25,273,407,-134,122,98.16
Hawai'i,2018,8,14,0.5714285714285714,431,491,-60,108,111.87
Hawai'i,2019,10,15,0.6666666666666666,508,478,30,86,133.96
Hawai'i,2020,5,9,0.5555555555555556,236,248,-12,96,138.46
Hawai'i,2021,6,13,0.4615384615384615,374,408,-34,115,129.53
Hawai'i,2022,3,13,0.2307692307692307,257,451,-194,127,124.35
Hawai'i,2023,5,13,0.3846153846153846,278,419,-141,127,90.15
Holy Cross,2016,4,11,0.3636363636363636,259,355,-96,184,15.49
Holy Cross,2017,4,11,0.3636363636363636,254,279,-25,203,13.29
Holy Cross,2018,5,11,0.4545454545454545,268,286,-18,213,18.82
Holy Cross,2019,7,13,0.5384615384615384,297,316,-19,185,30.54
Holy Cross,2020,3,4,0.75,90,68,22,193,16.26
Holy Cross,2021,10,13,0.7692307692307693,419,240,179,161,51.84
Holy Cross,2022,12,13,0.9230769230769232,486,279,207,162,41.97
Holy Cross,2023,7,11,0.6363636363636364,406,283,123,181,10.14
Houston,2015,13,14,0.9285714285714286,566,290,276,57,171.4
Houston,2016,9,13,0.6923076923076923,466,305,161,75,144.26
Houston,2017,7,12,0.5833333333333334,339,286,53,89,131.58
Houston,2018,8,13,0.6153846153846154,571,483,88,36,201.5
Houston,2019,4,12,0.3333333333333333,368,408,-40,69,160.34
Houston,2020,3,8,0.375,240,256,-16,73,166.86
Houston,2021,12,14,0.8571428571428571,502,286,216,72,165.39
Houston,2022,8,13,0.6153846153846154,469,418,51,82,155.32
Houston,2023,4,12,0.3333333333333333,284,378,-94,81,153.47
Houston Christian,2015,1,10,0.1,157,396,-239,180,12.64
Houston Christian,2016,4,11,0.3636363636363636,207,383,-176,213,9.34
Houston Christian,2018,1,11,0.0909090909090909,301,481,-180,239,9.95
Houston Christian,2019,5,12,0.4166666666666667,429,441,-12,178,34.26
Houston Christian,2020,1,4,0.25,135,188,-53,176,24.06
Houston Christian,2021,0,11,0.0,191,459,-268,164,47.53
Houston Christian,2022,2,11,0.1818181818181818,198,405,-207,198,20.55
Howard,2016,2,11,0.1818181818181818,208,383,-175,242,3.98
Howard,2018,4,10,0.4,336,341,-5,285,-0.03
Howard,2019,2,12,0.1666666666666666,199,539,-340,191,27.75
Howard,2020,0,2,0.0,38,54,-16,156,34.71
Howard,2021,3,11,0.2727272727272727,260,328,-68,168,43.12
Howard,2023,6,12,0.5,342,285,57,149,27.3
Idaho,2015,4,12,0.3333333333333333,364,505,-141,124,80.11
Idaho,2016,9,13,0.6923076923076923,400,407,-7,129,77.86
Idaho,2017,4,12,0.3333333333333333,251,309,-58,121,98.54
Idaho,2018,4,11,0.3636363636363636,274,412,-138,123,101.42
Idaho,2019,5,12,0.4166666666666667,308,406,-98,134,83.36
Idaho,2020,2,6,0.3333333333333333,140,161,-21,132,90.2
Idaho,2021,4,11,0.3636363636363636,279,347,-68,137,99.19
Idaho,2022,7,12,0.5833333333333334,431,305,126,134,96.43
Idaho,2023,9,13,0.6923076923076923,420,287,133,132,62.38
Idaho State,2016,1,10,0.1,220,448,-228,194,13.29
Idaho State,2017,4,11,0.3636363636363636,309,391,-82,224,8.57
Idaho State,2018,6,11,0.5454545454545454,388,363,25,169,45.42
Idaho State,2019,3,12,0.25,270,418,-148,234,8.17
Idaho State,2020,2,6,0.3333333333333333,155,192,-37,179,21.73
Idaho State,2021,1,11,0.0909090909090909,168,375,-207,146,72.23
Idaho State,2022,1,11,0.0909090909090909,151,402,-251,165,39.12
Illinois,2015,5,12,0.4166666666666667,272,279,-7,51,176.35
Illinois,2016,3,12,0.25,236,383,-147,72,153.35
Illinois,2017,2,12,0.1666666666666666,185,378,-193,48,181.74
Illinois,2018,4,12,0.3333333333333333,312,473,-161,73,153.64
Illinois,2019,6,13,0.4615384615384615,347,340,7,46,185.24
Illinois,2020,2,8,0.25,161,279,-118,54,185.83
Illinois,2021,5,12,0.4166666666666667,242,263,-21,53,184.37
Illinois,2022,8,13,0.6153846153846154,315,166,149,87,152.9
Illinois,2023,5,12,0.4166666666666667,294,353,-59,73,159.12
Illinois State,2015,10,13,0.7692307692307693,451,276,175,158,22.06
Illinois State,2016,6,12,0.5,312,262,50,130,75.99
Illinois State,2017,6,11,0.5454545454545454,287,213,74,163,32.28
Illinois State,2018,6,11,0.5454545454545454,350,220,130,182,34.92
Illinois State,2019,10,15,0.6666666666666666,297,240,57,156,54.55
Illinois State,2020,1,4,0.25,69,86,-17,163,30.7
Illinois State,2021,4,11,0.3636363636363636,202,246,-44,149,69.17
Illinois State,2022,6,11,0.5454545454545454,190,224,-34,153,56.34
Indiana,2015,6,13,0.4615384615384615,475,489,-14,42,190.33
Indiana,2016,6,13,0.4615384615384615,335,354,-19,48,180.46
Indiana,2017,5,12,0.4166666666666667,322,304,18,53,175.35
Indiana,2018,5,12,0.4166666666666667,317,359,-42,53,172.23
Indiana,2019,8,13,0.6153846153846154,413,317,96,62,167.99
Indiana,2020,6,8,0.75,231,162,69,50,190.77
Indiana,2021,2,12,0.1666666666666666,207,399,-192,36,202.63
Indiana,2022,4,12,0.3333333333333333,279,407,-128,58,177.39
Indiana,2023,3,12,0.25,266,359,-93,54,177.78
Indiana State,2015,5,11,0.4545454545454545,305,346,-41,146,28.73
Indiana State,2016,4,11,0.3636363636363636,274,359,-85,150,30.33
Indiana State,2017,0,11,0.0,158,494,-336,185,19.63
Indiana State,2018,7,11,0.6363636363636364,349,310,39,176,39.37
Indiana State,2019,5,12,0.4166666666666667,235,274,-39,197,24.61
Indiana State,2021,5,11,0.4545454545454545,175,330,-155,187,32.33
Indiana State,2022,2,11,0.1818181818181818,176,360,-184,208,16.73
Iowa,2015,12,14,0.8571428571428571,433,285,148,56,171.96
Iowa,2016,8,13,0.6153846153846154,324,245,79,58,171.84
Iowa,2017,8,13,0.6153846153846154,367,259,108,59,169.99
Iowa,2018,9,13,0.6923076923076923,405,231,174,47,181.39
Iowa,2019,10,13,0.7692307692307693,335,182,153,41,191.44
Iowa,2020,6,8,0.75,254,128,126,39,203.34
Iowa,2021,10,14,0.7142857142857143,328,269,59,41,199.36
Iowa,2022,8,13,0.6153846153846154,230,173,57,35,203.81
Iowa,2023,10,14,0.7142857142857143,216,207,9,23,213.89
Iowa State,2015,3,12,0.25,300,392,-92,63,159.52
Iowa State,2016,3,12,0.25,332,376,-44,59,171.65
Iowa State,2017,8,13,0.6153846153846154,380,272,108,64,166.5
Iowa State,2018,8,13,0.6153846153846154,348,298,50,55,170.58
Iowa State,2019,7,13,0.5384615384615384,418,337,81,52,180.53
Iowa State,2020,9,12,0.75,395,257,138,55,185.19
Iowa State,2021,7,13,0.5384615384615384,407,267,140,46,192.25
Iowa State,2022,4,12,0.3333333333333333,242,243,-1,46,190.9
Iowa State,2023,7,13,0.5384615384615384,341,296,45,59,175.58
Jackson State,2015,2,10,0.2,218,348,-130,148,28.24
Jackson State,2016,3,11,0.2727272727272727,203,317,-114,188,14.23
Jackson State,2017,3,11,0.2727272727272727,140,284,-144,218,9.56
Jackson State,2018,5,10,0.5,165,245,-80,185,31.8
Jackson State,2019,4,12,0.3333333333333333,313,429,-116,188,28.73
Jackson State,2023,7,11,0.6363636363636364,300,263,37,85,147.9
Jacksonville,2015,9,11,0.8181818181818182,335,210,125,174,14.62
Jacksonville,2016,5,10,0.5,326,333,-7,198,12.94
Jacksonville,2017,7,11,0.6363636363636364,324,385,-61,265,-0.03
Jacksonville State,2015,13,15,0.8666666666666667,584,299,285,134,42.28
Jacksonville State,2016,10,12,0.8333333333333334,371,219,152,136,47.91
Jacksonville State,2017,10,12,0.8333333333333334,346,180,166,133,59.0
Jacksonville State,2018,9,13,0.6923076923076923,520,323,197,151,58.06
Jacksonville State,2019,6,12,0.5,328,331,-3,148,66.06
Jacksonville State,2020,10,13,0.7692307692307693,369,229,140,142,72.9
Jacksonville State,2021,5,11,0.4545454545454545,242,312,-70,145,79.23
Jacksonville State,2022,9,11,0.8181818181818182,398,252,146,210,16.49
Jacksonville State,2023,9,13,0.6923076923076923,392,275,117,160,16.83
James Madison,2015,9,12,0.75,531,344,187,178,13.66
James Madison,2016,14,15,0.9333333333333332,700,318,382,166,20.2
James Madison,2017,14,15,0.9333333333333332,516,167,349,135,46.41
James Madison,2018,9,13,0.6923076923076923,441,190,251,156,55.72
James Madison,2019,14,16,0.875,640,251,389,147,67.71
James Madison,2020,7,8,0.875,269,132,137,171,26.73
James Madison,2021,12,14,0.8571428571428571,536,216,320,147,70.12
James Madison,2022,8,11,0.7272727272727273,407,230,177,170,35.08
James Madison,2023,11,13,0.8461538461538461,443,253,190,140,46.14
Kansas,2015,0,12,0.0,183,553,-370,49,180.28
Kansas,2016,2,12,0.1666666666666666,243,448,-205,50,177.14
Kansas,2017,1,12,0.0833333333333333,224,521,-297,73,153.94
Kansas,2018,3,12,0.25,286,360,-74,70,159.19
Kansas,2019,3,12,0.25,282,433,-151,71,159.35
Kansas,2020,0,9,0.0,142,414,-272,60,178.59
Kansas,2021,2,12,0.1666666666666666,249,506,-257,70,165.84
Kansas,2022,6,13,0.4615384615384615,463,461,2,57,178.97
Kansas,2023,9,13,0.6923076923076923,452,345,107,52,183.13
Kansas State,2015,6,13,0.4615384615384615,389,409,-20,64,158.71
Kansas State,2016,9,13,0.6923076923076923,419,290,129,49,178.29
Kansas State,2017,8,13,0.6153846153846154,420,327,93,54,175.02
Kansas State,2018,5,12,0.4166666666666667,270,305,-35,72,155.49
Kansas State,2019,8,13,0.6153846153846154,385,278,107,61,169.37
Kansas State,2020,4,10,0.4,266,322,-56,66,175.65
Kansas State,2021,8,13,0.6153846153846154,358,273,85,62,177.4
Kansas State,2022,10,14,0.7142857142857143,452,306,146,51,182.46
Kansas State,2023,9,13,0.6923076923076923,482,273,209,56,176.98
Kennesaw State,2016,8,11,0.7272727272727273,428,239,189,146,32.95
Kennesaw State,2017,12,14,0.8571428571428571,421,217,204,193,15.83
Kennesaw State,2018,11,13,0.8461538461538461,565,200,365,207,20.0
Kennesaw State,2019,11,14,0.7857142857142857,530,262,268,160,51.87
Kennesaw State,2020,4,5,0.8,148,91,57,147,52.74
Kennesaw State,2021,11,13,0.8461538461538461,427,253,174,150,69.12
Kennesaw State,2022,5,11,0.4545454545454545,302,385,-83,154,55.15
Kennesaw State,2023,3,9,0.3333333333333333,235,161,74,157,20.61
Kent State,2015,3,12,0.25,157,313,-156,118,95.27
Kent State,2016,3,12,0.25,247,344,-97,123,86.65
Kent State,2017,2,12,0.1666666666666666,153,421,-268,102,119.93
Kent State,2018,2,12,0.1666666666666666,287,440,-153,131,82.77
Kent State,2019,7,13,0.5384615384615384,380,414,-34,128,94.88
Kent State,2020,3,4,0.75,199,152,47,100,127.72
Kent State,2021,7,14,0.5,462,508,-46,102,138.12
Kent State,2022,5,12,0.4166666666666667,341,348,-7,108,141.52
Kent State,2023,1,12,0.0833333333333333,176,415,-239,118,119.36
Kentucky,2015,5,12,0.4166666666666667,296,329,-33,34,195.55
Kentucky,2016,7,13,0.5384615384615384,390,407,-17,22,225.4
Kentucky,2017,7,13,0.5384615384615384,332,367,-35,38,193.19
Kentucky,2018,10,13,0.7692307692307693,346,219,127,34,204.07
Kentucky,2019,8,13,0.6153846153846154,353,251,102,30,207.73
Kentucky,2020,5,11,0.4545454545454545,240,285,-45,37,206.91
Kentucky,2021,10,13,0.7692307692307693,420,282,138,34,203.49
Kentucky,2022,7,13,0.5384615384615384,265,250,15,23,229.87
Kentucky,2023,7,13,0.5384615384615384,378,336,42,32,205.02
LSU,2015,9,12,0.75,394,291,103,6,281.05
LSU,2016,8,12,0.6666666666666666,340,189,151,2,299.29
LSU,2017,9,13,0.6923076923076923,354,246,108,5,284.37
LSU,2018,10,13,0.7692307692307693,421,283,138,2,295.03
LSU,2019,15,15,1.0,726,328,398,7,287.66
LSU,2020,5,10,0.5,320,349,-29,15,254.38
LSU,2021,6,13,0.4615384615384615,345,346,-1,5,284.06
LSU,2022,10,14,0.7142857142857143,483,315,168,4,300.54
LSU,2023,10,13,0.7692307692307693,592,364,228,4,291.37
Lafayette,2016,2,11,0.1818181818181818,216,386,-170,181,15.94
Lafayette,2017,3,11,0.2727272727272727,132,299,-167,150,35.89
Lafayette,2018,3,11,0.2727272727272727,143,323,-180,224,14.44
Lafayette,2019,4,12,0.3333333333333333,221,319,-98,170,40.25
Lafayette,2020,2,3,0.6666666666666666,57,61,-4,180,20.12
Lafayette,2021,3,11,0.2727272727272727,182,259,-77,237,8.42
Lafayette,2022,4,11,0.3636363636363636,139,239,-100,240,6.97
Lafayette,2023,9,12,0.75,360,280,80,182,10.14
Lamar,2015,5,11,0.4545454545454545,394,334,60,173,14.99
Lamar,2016,3,11,0.2727272727272727,230,336,-106,180,16.46
Lamar,2017,1,10,0.1,175,385,-210,233,6.31
Lamar,2018,7,12,0.5833333333333334,371,340,31,135,79.32
Lamar,2019,4,12,0.3333333333333333,265,380,-115,166,47.23
Lamar,2020,2,6,0.3333333333333333,97,250,-153,152,41.65
Lamar,2021,1,10,0.1,123,398,-275,175,35.77
Lamar,2023,6,11,0.5454545454545454,270,259,11,141,39.38
Lehigh,2015,6,11,0.5454545454545454,355,388,-33,165,20.11
Lehigh,2016,9,12,0.75,466,323,143,225,7.43
Lehigh,2017,5,12,0.4166666666666667,430,492,-62,182,21.25
Lehigh,2018,3,11,0.2727272727272727,183,386,-203,178,37.73
Lehigh,2019,4,11,0.3636363636363636,173,235,-62,198,24.26
Lehigh,2020,0,3,0.0,16,46,-30,204,11.91
Lehigh,2022,2,11,0.1818181818181818,189,325,-136,239,6.97
Lehigh,2023,2,11,0.1818181818181818,203,343,-140,164,14.77
Liberty,2016,6,11,0.5454545454545454,302,286,16,224,7.63
Liberty,2017,6,11,0.5454545454545454,358,334,24,142,38.13
Liberty,2018,6,12,0.5,399,442,-43,180,35.65
Liberty,2019,8,13,0.6153846153846154,427,365,62,171,40.17
Liberty,2020,10,11,0.9090909090909092,420,226,194,137,80.33
Liberty,2021,8,13,0.6153846153846154,437,280,157,135,108.39
Liberty,2022,8,13,0.6153846153846154,358,320,38,95,146.5
Liberty,2023,13,14,0.9285714285714286,536,340,196,111,129.14
Louisiana,2015,4,12,0.3333333333333333,317,382,-65,80,138.35
Louisiana,2016,6,13,0.4615384615384615,307,329,-22,107,102.49
Louisiana,2017,5,12,0.4166666666666667,338,480,-142,78,146.18
Louisiana,2018,7,14,0.5,447,479,-32,106,115.83
Louisiana,2019,11,14,0.7857142857142857,531,276,255,121,104.33
Louisiana,2020,10,11,0.9090909090909092,370,242,128,105,124.91
Louisiana,2021,13,14,0.9285714285714286,435,259,176,76,158.45
Louisiana,2022,6,13,0.4615384615384615,340,297,43,79,158.34
Louisiana,2023,6,13,0.4615384615384615,418,372,46,79,154.78
Louisiana Tech,2015,9,13,0.6923076923076923,488,349,139,89,124.51
Louisiana Tech,2016,9,14,0.6428571428571429,620,470,150,89,119.17
Louisiana Tech,2017,7,13,0.5384615384615384,396,330,66,82,142.32
Louisiana Tech,2018,8,13,0.6153846153846154,321,299,22,94,128.91
Louisiana Tech,2019,10,13,0.7692307692307693,422,284,138,100,121.72
Louisiana Tech,2020,5,10,0.5,267,347,-80,77,162.18
Louisiana Tech,2021,3,12,0.25,336,408,-72,83,155.46
Louisiana Tech,2022,3,12,0.25,348,455,-107,75,162.08
Louisiana Tech,2023,3,12,0.25,311,401,-90,121,108.45
Louisville,2015,8,13,0.6153846153846154,373,313,60,36,194.03
Louisville,2016,9,13,0.6923076923076923,553,309,244,45,183.64
Louisville,2017,8,13,0.6153846153846154,495,356,139,33,201.4
Louisville,2018,2,12,0.1666666666666666,237,529,-292,38,196.02
Louisville,2019,8,13,0.6153846153846154,430,434,-4,34,205.15
Louisville,2020,4,11,0.3636363636363636,325,293,32,30,213.58
Louisville,2021,6,13,0.4615384615384615,411,355,56,69,165.93
Louisville,2022,8,13,0.6153846153846154,350,249,101,42,194.46
Louisville,2023,10,14,0.7142857142857143,430,298,132,38,198.01
Maine,2015,3,11,0.2727272727272727,164,237,-73,200,7.32
Maine,2016,6,11,0.5454545454545454,245,288,-43,234,6.59
Maine,2017,4,10,0.4,246,233,13,223,8.86
Maine,2018,10,14,0.7142857142857143,371,327,44,286,-0.11
Maine,2019,6,12,0.5,352,353,-1,226,10.24
Maine,2021,6,11,0.5454545454545454,275,297,-22,205,22.07
Maine,2023,2,11,0.1818181818181818,259,360,-101,174,12.51
Marist,2016,5,11,0.4545454545454545,276,321,-45,279,-0.03
Marist,2017,4,11,0.3636363636363636,234,338,-104,199,13.67
Marist,2019,4,11,0.3636363636363636,237,381,-144,243,6.67
Marist,2022,4,11,0.3636363636363636,236,327,-91,242,6.3
Marshall,2015,10,13,0.7692307692307693,407,231,176,58,170.81
Marshall,2016,3,12,0.25,317,423,-106,62,165.64
Marshall,2017,8,13,0.6153846153846154,347,259,88,75,149.98
Marshall,2018,9,13,0.6923076923076923,367,284,83,51,176.55
Marshall,2019,8,13,0.6153846153846154,335,325,10,87,132.84
Marshall,2020,7,10,0.7,285,130,155,74,165.85
Marshall,2021,7,13,0.5384615384615384,429,309,120,71,165.42
Marshall,2022,9,13,0.6923076923076923,318,208,110,96,146.14
Marshall,2023,6,13,0.4615384615384615,296,373,-77,125,101.55
Maryland,2015,3,12,0.25,296,413,-117,38,193.11
Maryland,2016,6,13,0.4615384615384615,335,384,-49,41,190.98
Maryland,2017,4,12,0.3333333333333333,289,445,-156,47,182.31
Maryland,2018,5,12,0.4166666666666667,342,344,-2,41,190.15
Maryland,2019,3,12,0.25,303,416,-113,18,230.17
Maryland,2020,2,5,0.4,118,160,-42,28,218.34
Maryland,2021,7,13,0.5384615384615384,381,399,-18,47,192.18
Maryland,2022,8,13,0.6153846153846154,366,301,65,31,209.67
Maryland,2023,8,13,0.6153846153846154,386,292,94,19,230.29
Massachusetts,2015,3,12,0.25,266,377,-111,101,112.55
Massachusetts,2016,2,12,0.1666666666666666,280,426,-146,120,87.9
Massachusetts,2017,4,12,0.3333333333333333,367,382,-15,107,118.12
Massachusetts,2018,4,12,0.3333333333333333,394,515,-121,86,136.04
Massachusetts,2019,1,12,0.0833333333333333,237,632,-395,110,115.82
Massachusetts,2020,0,4,0.0,12,161,-149,108,123.66
Massachusetts,2021,1,12,0.0833333333333333,196,517,-321,113,130.79
Massachusetts,2022,1,12,0.0833333333333333,150,373,-223,100,145.02
Massachusetts,2023,3,12,0.25,278,454,-176,117,121.74
McNeese,2015,9,10,0.9,295,138,157,171,16.23
McNeese,2016,6,11,0.5454545454545454,352,285,67,189,14.19
McNeese,2017,8,10,0.8,286,167,119,213,10.93
McNeese,2018,6,11,0.5454545454545454,229,266,-37,163,46.78
McNeese,2019,7,12,0.5833333333333334,313,311,2,184,31.02
McNeese,2020,3,7,0.4285714285714285,183,202,-19,199,14.46
McNeese,2021,4,11,0.3636363636363636,270,280,-10,170,39.93
McNeese,2023,0,10,0.0,191,374,-183,169,13.17
Memphis,2015,9,13,0.6923076923076923,522,355,167,90,123.56
Memphis,2016,8,13,0.6153846153846154,505,375,130,78,135.91
Memphis,2017,10,13,0.7692307692307693,592,422,170,77,146.79
Memphis,2018,8,14,0.5714285714285714,601,447,154,61,165.98
Memphis,2019,12,14,0.8571428571428571,566,370,196,56,177.6
Memphis,2020,8,11,0.7272727272727273,341,307,34,81,157.28
Memphis,2021,6,12,0.5,361,351,10,67,172.4
Memphis,2022,7,13,0.5384615384615384,459,338,121,67,165.67
Memphis,2023,10,13,0.7692307692307693,512,374,138,46,187.31
Mercer,2016,6,11,0.5454545454545454,298,318,-20,160,23.5
Mercer,2017,5,11,0.4545454545454545,270,260,10,176,23.29
Mercer,2018,5,11,0.4545454545454545,337,357,-20,187,29.96
Mercer,2019,4,12,0.3333333333333333,323,425,-102,138,79.49
Mercer,2020,5,11,0.4545454545454545,265,330,-65,138,80.23
Mercer,2021,7,10,0.7,317,227,90,139,92.53
Mercer,2022,7,11,0.6363636363636364,420,243,177,179,28.8
Miami,2015,8,13,0.6153846153846154,361,366,-5,14,249.66
Miami,2016,9,13,0.6923076923076923,446,241,205,12,256.08
Miami,2017,10,13,0.7692307692307693,378,273,105,27,215.49
Miami,2018,7,13,0.5384615384615384,374,253,121,22,231.78
Miami,2019,6,13,0.4615384615384615,334,263,71,12,248.67
Miami,2020,8,11,0.7272727272727273,374,297,77,8,280.87
Miami,2021,7,12,0.5833333333333334,409,341,68,27,222.07
Miami,2022,5,12,0.4166666666666667,283,321,-38,13,256.71
Miami,2023,7,13,0.5384615384615384,409,296,113,12,263.12
Miami (OH),2015,3,12,0.25,215,384,-169,106,107.36
Miami (OH),2016,6,13,0.4615384615384615,297,309,-12,125,84.76
Miami (OH),2017,5,12,0.4166666666666667,293,289,4,74,150.48
Miami (OH),2018,6,12,0.5,337,306,31,93,129.79
Miami (OH),2019,8,14,0.5714285714285714,338,394,-56,94,126.73
Miami (OH),2020,2,3,0.6666666666666666,86,80,6,130,103.16
Miami (OH),2021,7,13,0.5384615384615384,376,300,76,89,151.13
Miami (OH),2022,6,13,0.4615384615384615,263,294,-31,89,150.61
Miami (OH),2023,11,14,0.7857142857142857,359,223,136,88,146.03
Michigan,2015,10,13,0.7692307692307693,408,213,195,4,288.74
Michigan,2016,10,13,0.7692307692307693,524,183,341,20,233.54
Michigan,2017,8,13,0.6153846153846154,328,245,83,37,194.82
Michigan,2018,10,13,0.7692307692307693,457,252,205,8,280.38
Michigan,2019,9,13,0.6923076923076923,412,269,143,5,296.03
Michigan,2020,2,6,0.3333333333333333,170,207,-37,22,230.56
Michigan,2021,12,14,0.8571428571428571,501,243,258,8,277.15
Michigan,2022,13,14,0.9285714285714286,566,225,341,14,256.34
Michigan,2023,15,15,1.0,538,156,382,10,268.77
Michigan State,2015,12,14,0.8571428571428571,417,304,113,37,193.96
Michigan State,2016,3,12,0.25,289,333,-44,26,217.62
Michigan State,2017,10,13,0.7692307692307693,319,260,59,23,221.77
Michigan State,2018,7,13,0.5384615384615384,243,223,20,17,239.13
Michigan State,2019,7,13,0.5384615384615384,291,293,-2,36,203.65
Michigan State,2020,2,7,0.2857142857142857,126,246,-120,31,212.21
Michigan State,2021,11,13,0.8461538461538461,414,329,85,32,215.21
Michigan State,2022,5,12,0.4166666666666667,293,329,-36,43,193.32
Michigan State,2023,4,12,0.3333333333333333,191,340,-149,43,190.6
Middle Tennessee,2015,7,13,0.5384615384615384,442,346,96,87,125.23
Middle Tennessee,2016,8,13,0.6153846153846154,516,465,51,85,124.03
Middle Tennessee,2017,7,13,0.5384615384615384,332,321,11,86,134.77
Middle Tennessee,2018,8,14,0.5714285714285714,392,374,18,96,128.26
Middle Tennessee,2019,4,12,0.3333333333333333,316,359,-43,91,128.1
Middle Tennessee,2020,3,9,0.3333333333333333,206,319,-113,104,125.31
Middle Tennessee,2021,7,13,0.5384615384615384,388,334,54,85,154.43
Middle Tennessee,2022,8,13,0.6153846153846154,375,360,15,90,150.6
Middle Tennessee,2023,4,12,0.3333333333333333,291,337,-46,123,107.22
Minnesota,2015,6,13,0.4615384615384615,292,327,-35,67,152.11
Minnesota,2016,9,13,0.6923076923076923,381,287,94,57,172.32
Minnesota,2017,5,12,0.4166666666666667,265,274,-9,63,167.01
Minnesota,2018,7,13,0.5384615384615384,376,345,31,46,182.22
Minnesota,2019,11,13,0.8461538461538461,443,293,150,59,171.42
Minnesota,2020,3,7,0.4285714285714285,191,211,-20,38,206.66
Minnesota,2021,9,13,0.6923076923076923,331,225,106,45,194.48
Minnesota,2022,9,13,0.6923076923076923,367,180,187,38,199.35
Minnesota,2023,6,13,0.4615384615384615,272,347,-75,37,199.4
Mississippi State,2015,9,13,0.6923076923076923,447,302,145,24,214.76
Mississippi State,2016,6,13,0.4615384615384615,395,413,-18,36,199.92
Mississippi State,2017,9,13,0.6923076923076923,416,272,144,18,237.46
Mississippi State,2018,8,13,0.6153846153846154,371,171,200,28,211.11
Mississippi State,2019,6,13,0.4615384615384615,359,375,-16,24,220.22
Mississippi State,2020,4,11,0.3636363636363636,235,309,-74,27,218.47
Mississippi State,2021,7,13,0.5384615384615384,378,337,41,24,236.6
Mississippi State,2022,9,13,0.6923076923076923,411,300,111,27,220.24
Mississippi State,2023,5,12,0.4166666666666667,262,319,-57,25,210.6
Mississippi Valley State,2017,2,11,0.1818181818181818,164,445,-281,238,3.3
Mississippi Valley State,2020,1,4,0.25,43,109,-66,213,9.53
Missouri,2015,5,12,0.4166666666666667,163,194,-31,43,189.91
Missouri,2016,4,12,0.3333333333333333,377,378,-1,37,198.53
Missouri,2017,7,13,0.5384615384615384,488,414,74,25,217.98
Missouri,2018,8,13,0.6153846153846154,476,331,145,43,188.37
Missouri,2019,6,12,0.5,304,233,71,43,187.71
Missouri,2020,5,10,0.5,267,323,-56,43,197.38
Missouri,2021,6,13,0.4615384615384615,378,440,-62,37,202.13
Missouri,2022,6,13,0.4615384615384615,323,327,-4,50,182.85
Missouri,2023,11,13,0.8461538461538461,423,271,152,27,210.28
Missouri State,2016,4,11,0.3636363636363636,257,393,-136,151,28.44
Missouri State,2017,3,11,0.2727272727272727,266,421,-155,215,10.0
Missouri State,2018,4,11,0.3636363636363636,253,396,-143,193,27.34
Missouri State,2019,1,11,0.0909090909090909,170,397,-227,182,32.02
Missouri State,2020,5,10,0.5,175,268,-93,183,17.93
Missouri State,2021,8,12,0.6666666666666666,411,314,97,207,21.02
Missouri State,2022,5,11,0.4545454545454545,301,300,1,164,39.43
Monmouth,2016,4,11,0.3636363636363636,280,361,-81,169,19.29
Monmouth,2017,9,12,0.75,394,331,63,154,35.02
Monmouth,2018,8,11,0.7272727272727273,365,347,18,241,8.82
Monmouth,2019,11,14,0.7857142857142857,501,381,120,168,40.88
Monmouth,2020,3,4,0.75,140,74,66,223,7.98
Monmouth,2021,7,11,0.6363636363636364,354,302,52,228,11.98
Montana,2015,8,13,0.6153846153846154,381,320,61,166,19.94
Montana,2017,7,11,0.6363636363636364,385,319,66,147,37.09
Montana,2018,6,11,0.5454545454545454,373,314,59,137,75.88
Montana,2019,10,14,0.7142857142857143,514,351,163,164,48.96
Montana,2020,2,2,1.0,107,10,97,162,30.84
Montana,2021,10,13,0.7692307692307693,385,212,173,148,69.85
Montana,2022,8,13,0.6153846153846154,470,277,193,155,51.3
Montana,2023,13,15,0.8666666666666667,454,258,196,190,7.3
Montana State,2015,5,11,0.4545454545454545,461,377,84,157,22.21
Montana State,2016,4,11,0.3636363636363636,282,276,6,232,6.64
Montana State,2017,5,11,0.4545454545454545,278,275,3,226,7.98
Montana State,2018,8,13,0.6153846153846154,370,370,0,165,46.61
Montana State,2019,11,15,0.7333333333333333,490,331,159,143,71.96
Montana State,2021,12,15,0.8,430,226,204,151,66.92
Montana State,2022,12,14,0.8571428571428571,601,366,235,133,101.69
Montana State,2023,8,12,0.6666666666666666,479,262,217,152,24.7
Morehead State,2018,3,11,0.2727272727272727,303,475,-172,220,15.51
Morehead State,2019,5,12,0.4166666666666667,345,415,-70,252,5.81
Morehead State,2020,4,7,0.5714285714285714,159,177,-18,235,5.8
Morgan State,2017,1,11,0.0909090909090909,214,405,-191,266,-0.03
Morgan State,2018,4,11,0.3636363636363636,206,282,-76,246,6.67
Morgan State,2019,3,12,0.25,225,380,-155,209,15.74
Morgan State,2021,2,11,0.1818181818181818,154,347,-193,188,31.01
Morgan State,2023,4,10,0.4,161,214,-53,150,26.96
Murray State,2015,3,11,0.2727272727272727,336,409,-73,140,33.47
Murray State,2016,4,11,0.3636363636363636,287,387,-100,155,25.6
Murray State,2017,3,11,0.2727272727272727,232,322,-90,220,9.32
Murray State,2018,5,11,0.4545454545454545,307,384,-77,171,42.71
Murray State,2019,4,12,0.3333333333333333,274,347,-73,223,10.99
Murray State,2020,5,7,0.7142857142857143,195,164,31,166,28.3
Murray State,2021,6,11,0.5454545454545454,237,278,-41,159,54.92
NC State,2015,7,13,0.5384615384615384,432,336,96,59,166.04
NC State,2016,7,13,0.5384615384615384,351,296,55,34,201.31
NC State,2017,9,13,0.6923076923076923,419,328,91,31,208.69
NC State,2018,9,13,0.6923076923076923,440,324,116,50,177.67
NC State,2019,4,12,0.3333333333333333,265,361,-96,53,180.46
NC State,2020,8,12,0.6666666666666666,363,350,13,26,220.57
NC State,2021,9,12,0.75,397,236,161,31,217.29
NC State,2022,8,13,0.6153846153846154,316,249,67,41,194.78
NC State,2023,9,13,0.6923076923076923,341,270,71,34,202.42
Navy,2015,11,13,0.8461538461538461,478,284,194,116,97.15
Navy,2016,9,14,0.6428571428571429,531,434,97,108,101.9
Navy,2017,7,13,0.5384615384615384,396,342,54,112,114.7
Navy,2018,3,13,0.2307692307692307,325,436,-111,91,132.07
Navy,2019,11,13,0.8461538461538461,483,290,193,88,131.73
Navy,2020,3,10,0.3,166,303,-137,106,124.71
Navy,2021,4,12,0.3333333333333333,241,339,-98,124,124.39
Navy,2022,4,12,0.3333333333333333,263,292,-29,126,128.76
Navy,2023,5,12,0.4166666666666667,212,269,-57,107,131.51
Nebraska,2015,6,13,0.4615384615384615,427,362,65,22,220.72
Nebraska,2016,9,13,0.6923076923076923,345,311,34,35,200.24
Nebraska,2017,4,12,0.3333333333333333,309,437,-128,30,211.72
Nebraska,2018,4,12,0.3333333333333333,360,375,-15,26,216.76
Nebraska,2019,5,12,0.4166666666666667,336,333,3,23,224.33
Nebraska,2020,3,8,0.375,185,235,-50,23,227.95
Nebraska,2021,3,12,0.25,335,272,63,18,245.1
Nebraska,2022,4,12,0.3333333333333333,271,331,-60,20,240.27
Nebraska,2023,5,12,0.4166666666666667,216,219,-3,20,216.5
Nevada,2015,7,13,0.5384615384615384,341,349,-8,88,124.94
Nevada,2016,5,12,0.4166666666666667,305,348,-43,81,126.15
Nevada,2017,3,12,0.25,338,407,-69,98,122.5
Nevada,2018,8,13,0.6153846153846154,404,350,54,105,118.76
Nevada,2019,7,13,0.5384615384615384,277,415,-138,95,125.03
Nevada,2020,7,9,0.7777777777777778,277,210,67,82,155.96
Nevada,2021,8,13,0.6153846153846154,464,345,119,93,145.27
Nevada,2022,2,12,0.1666666666666666,226,371,-145,119,132.46
Nevada,2023,2,12,0.1666666666666666,208,401,-193,86,146.32
New Hampshire,2016,8,13,0.6153846153846154,371,316,55,203,11.22
New Hampshire,2017,9,14,0.6428571428571429,309,301,8,190,16.61
New Hampshire,2018,4,11,0.3636363636363636,196,251,-55,222,14.63
New Hampshire,2019,6,11,0.5454545454545454,222,221,1,215,13.6
New Hampshire,2020,0,1,0.0,20,24,-4,224,7.98
New Hampshire,2021,3,11,0.2727272727272727,182,326,-144,185,32.54
New Mexico,2015,7,13,0.5384615384615384,389,369,20,93,122.45
New Mexico,2016,9,13,0.6923076923076923,477,409,68,93,112.56
New Mexico,2017,3,12,0.25,248,382,-134,116,110.03
New Mexico,2018,3,12,0.25,319,434,-115,83,141.76
New Mexico,2019,2,12,0.1666666666666666,267,446,-179,118,109.85
New Mexico,2020,2,7,0.2857142857142857,167,228,-61,124,110.31
New Mexico,2021,3,12,0.25,146,341,-195,119,126.28
New Mexico,2022,2,12,0.1666666666666666,157,312,-155,106,142.34
New Mexico,2023,4,12,0.3333333333333333,327,421,-94,94,140.75
New Mexico State,2015,3,12,0.25,343,540,-197,120,92.08
New Mexico State,2016,3,12,0.25,298,466,-168,122,86.79
New Mexico State,2017,7,13,0.5384615384615384,381,386,-5,125,87.78
New Mexico State,2018,3,12,0.25,303,496,-193,128,94.49
New Mexico State,2019,2,12,0.1666666666666666,260,492,-232,129,94.57
New Mexico State,2020,1,2,0.5,53,72,-19,125,109.3
New Mexico State,2021,2,12,0.1666666666666666,271,485,-214,120,125.55
New Mexico State,2022,7,13,0.5384615384615384,331,311,20,132,108.54
New Mexico State,2023,10,15,0.6666666666666666,412,342,70,114,126.9
Nicholls,2016,5,11,0.4545454545454545,333,328,5,147,32.13
Nicholls,2018,9,13,0.6923076923076923,420,284,136,174,41.98
Nicholls,2019,9,14,0.6428571428571429,391,381,10,249,6.67
Nicholls,2021,6,11,0.5454545454545454,367,314,53,181,33.85
Norfolk State,2016,4,11,0.3636363636363636,174,269,-95,219,8.64
Norfolk State,2017,4,11,0.3636363636363636,209,303,-94,225,7.98
Norfolk State,2018,4,11,0.3636363636363636,207,300,-93,216,16.68
North Carolina,2015,11,14,0.7857142857142857,570,343,227,28,206.42
North Carolina,2016,8,13,0.6153846153846154,420,324,96,30,213.58
North Carolina,2017,3,12,0.25,312,375,-63,28,214.05
North Carolina,2018,2,11,0.1818181818181818,301,380,-79,32,204.83
North Carolina,2019,7,13,0.5384615384615384,430,308,122,29,207.81
North Carolina,2020,8,12,0.6666666666666666,500,353,147,20,232.27
North Carolina,2021,6,13,0.4615384615384615,458,417,41,30,218.57
North Carolina,2022,9,14,0.6428571428571429,482,431,51,19,246.65
North Carolina,2023,8,13,0.6153846153846154,449,355,94,14,253.91
North Carolina A&T,2016,9,12,0.75,422,277,145,226,6.67
North Carolina A&T,2017,12,12,1.0,421,149,272,267,-0.03
North Carolina A&T,2018,10,12,0.8333333333333334,361,170,191,223,14.61
North Carolina A&T,2019,9,12,0.75,457,249,208,256,2.97
North Carolina A&T,2021,5,11,0.4545454545454545,251,285,-34,211,19.69
North Carolina A&T,2022,7,11,0.6363636363636364,315,291,24,225,11.52
North Carolina A&T,2023,1,11,0.0909090909090909,177,336,-159,142,38.9
North Carolina Central,2016,9,12,0.75,347,275,72,217,8.89
North Carolina Central,2017,7,11,0.6363636363636364,236,211,25,208,11.23
North Carolina Central,2018,5,11,0.4545454545454545,289,335,-46,200,24.82
North Carolina Central,2019,4,12,0.3333333333333333,210,328,-118,193,26.67
North Carolina Central,2021,6,11,0.5454545454545454,268,287,-19,199,24.99
North Carolina Central,2022,10,12,0.8333333333333334,463,258,205,219,12.65
North Dakota,2015,7,11,0.6363636363636364,309,283,26,208,6.67
North Dakota,2016,9,12,0.75,355,264,91,300,-0.08
North Dakota,2017,3,11,0.2727272727272727,277,381,-104,178,22.25
North Dakota,2018,6,11,0.5454545454545454,293,249,44,203,21.96
North Dakota,2019,7,12,0.5833333333333334,319,342,-23,158,53.96
North Dakota,2020,5,7,0.7142857142857143,209,147,62,164,30.23
North Dakota,2021,5,11,0.4545454545454545,269,223,46,196,27.5
North Dakota,2022,7,12,0.5833333333333334,364,370,-6,218,12.79
North Dakota,2023,7,12,0.5833333333333334,365,303,62,166,13.76
North Dakota State,2015,13,15,0.8666666666666667,524,230,294,218,0.0
North Dakota State,2016,12,14,0.8571428571428571,408,232,176,142,36.88
North Dakota State,2017,14,15,0.9333333333333332,581,174,407,132,63.16
North Dakota State,2018,15,15,1.0,622,189,433,136,77.25
North Dakota State,2019,16,16,1.0,596,197,399,135,82.65
North Dakota State,2020,7,10,0.7,260,190,70,134,86.92
North Dakota State,2021,14,15,0.9333333333333332,511,167,344,142,86.93
North Dakota State,2022,12,15,0.8,512,297,215,141,77.43
North Texas,2015,1,12,0.0833333333333333,182,495,-313,119,93.6
North Texas,2016,5,13,0.3846153846153846,322,424,-102,103,105.0
North Texas,2017,9,14,0.6428571428571429,497,490,7,94,126.6
North Texas,2018,9,13,0.6923076923076923,450,314,136,102,122.36
North Texas,2019,4,12,0.3333333333333333,367,390,-23,115,111.16
North Texas,2020,4,10,0.4,344,428,-84,101,127.14
North Texas,2021,6,13,0.4615384615384615,357,357,0,75,158.78
North Texas,2022,7,14,0.5,473,444,29,68,164.56
North Texas,2023,5,12,0.4166666666666667,414,445,-31,80,153.89
Northern Arizona,2015,7,11,0.6363636363636364,432,383,49,159,21.71
Northern Arizona,2016,5,11,0.4545454545454545,361,313,48,134,53.85
Northern Arizona,2017,7,12,0.5833333333333334,363,356,7,130,65.76
Northern Arizona,2018,4,10,0.4,258,322,-64,138,75.01
Northern Arizona,2019,4,12,0.3333333333333333,446,496,-50,140,77.63
Northern Arizona,2020,3,5,0.6,117,135,-18,198,14.61
Northern Arizona,2021,5,11,0.4545454545454545,271,330,-59,144,84.4
Northern Arizona,2022,3,11,0.2727272727272727,245,322,-77,139,86.06
Northern Arizona,2023,5,11,0.4545454545454545,303,340,-37,128,80.92
Northern Colorado,2015,6,11,0.5454545454545454,330,378,-48,170,16.28
Northern Colorado,2016,5,10,0.5,321,371,-50,164,20.55
Northern Colorado,2017,3,10,0.3,278,341,-63,201,13.33
Northern Colorado,2018,2,11,0.1818181818181818,262,391,-129,153,56.31
Northern Colorado,2019,2,12,0.1666666666666666,241,453,-212,165,47.94
Northern Colorado,2021,3,11,0.2727272727272727,164,329,-165,197,27.42
Northern Colorado,2022,3,11,0.2727272727272727,229,412,-183,167,36.46
Northern Colorado,2023,0,11,0.0,154,367,-213,188,8.31
Northern Illinois,2015,8,14,0.5714285714285714,436,387,49,102,108.89
Northern Illinois,2016,5,12,0.4166666666666667,366,364,2,98,109.52
Northern Illinois,2017,8,13,0.6153846153846154,376,286,90,83,138.94
Northern Illinois,2018,8,14,0.5714285714285714,282,317,-35,112,111.4
Northern Illinois,2019,5,12,0.4166666666666667,274,338,-64,97,122.74
Northern Illinois,2020,0,6,0.0,149,232,-83,93,141.69
Northern Illinois,2021,9,14,0.6428571428571429,451,472,-21,108,134.16
Northern Illinois,2022,3,12,0.25,327,393,-66,91,149.69
Northern Illinois,2023,7,13,0.5384615384615384,324,273,51,91,142.59
Northern Iowa,2015,9,14,0.6428571428571429,413,274,139,204,6.67
Northern Iowa,2016,5,11,0.4545454545454545,320,242,78,157,24.32
Northern Iowa,2017,8,13,0.6153846153846154,382,307,75,141,39.11
Northern Iowa,2018,7,13,0.5384615384615384,333,277,56,142,68.3
Northern Iowa,2019,10,15,0.6666666666666666,315,265,50,192,26.77
Northern Iowa,2020,3,7,0.4285714285714285,137,107,30,189,16.88
Northern Iowa,2021,6,12,0.5,299,216,83,153,62.42
Northern Iowa,2022,6,11,0.5454545454545454,363,283,80,146,69.28
Northern Iowa,2023,6,11,0.5454545454545454,288,293,-5,143,37.22
Northwestern,2015,10,13,0.7692307692307693,254,242,12,53,174.64
Northwestern,2016,7,13,0.5384615384615384,338,289,49,47,182.68
Northwestern,2017,10,13,0.7692307692307693,380,261,119,55,174.83
Northwestern,2018,9,14,0.6428571428571429,339,325,14,52,174.91
Northwestern,2019,3,12,0.25,196,283,-87,50,182.07
Northwestern,2020,7,9,0.7777777777777778,222,143,79,58,180.18
Northwestern,2021,3,12,0.25,199,348,-149,52,188.14
Northwestern,2022,1,12,0.0833333333333333,165,340,-175,47,190.69
Northwestern,2023,8,13,0.6153846153846154,287,293,-6,50,184.3
Northwestern State,2016,1,11,0.0909090909090909,249,370,-121,210,10.04
Northwestern State,2017,4,11,0.3636363636363636,250,346,-96,177,22.92
Northwestern State,2018,5,11,0.4545454545454545,312,380,-68,181,35.3
Northwestern State,2019,3,12,0.25,303,452,-149,202,21.78
Northwestern State,2020,1,6,0.1666666666666666,143,181,-38,197,14.69
Northwestern State,2021,3,11,0.2727272727272727,214,375,-161,212,19.61
Northwestern State,2023,0,9,0.0,84,216,-132,180,10.53
Notre Dame,2015,10,13,0.7692307692307693,445,313,132,5,284.77
Notre Dame,2016,4,12,0.3333333333333333,371,334,37,11,260.44
Notre Dame,2017,10,13,0.7692307692307693,445,279,166,13,267.79
Notre Dame,2018,12,13,0.9230769230769232,408,237,171,15,249.43
Notre Dame,2019,11,13,0.8461538461538461,478,233,245,10,251.32
Notre Dame,2020,10,12,0.8333333333333334,401,236,165,10,268.86
Notre Dame,2021,11,13,0.8461538461538461,458,256,202,16,258.56
Notre Dame,2022,9,13,0.6923076923076923,413,299,114,17,251.45
Notre Dame,2023,10,13,0.7692307692307693,509,207,302,9,269.15
Ohio,2015,8,13,0.6153846153846154,358,329,29,117,96.79
Ohio,2016,8,14,0.5714285714285714,368,317,51,102,105.12
Ohio,2017,9,13,0.6923076923076923,508,315,193,92,128.68
Ohio,2018,9,13,0.6923076923076923,521,320,201,115,109.82
Ohio,2019,7,13,0.5384615384615384,446,345,101,103,120.83
Ohio,2020,2,3,0.6666666666666666,103,50,53,121,110.94
Ohio,2021,3,12,0.25,271,364,-93,103,138.11
Ohio,2022,10,14,0.7142857142857143,445,396,49,129,116.96
Ohio,2023,10,13,0.7692307692307693,316,206,110,99,137.6
Ohio State,2015,12,13,0.9230769230769232,464,196,268,2,303.35
Ohio State,2016,11,13,0.8461538461538461,512,201,311,3,296.08
Ohio State,2017,12,14,0.8571428571428571,576,266,310,7,279.6
Ohio State,2018,13,14,0.9285714285714286,593,357,236,4,289.12
Ohio State,2019,13,14,0.9285714285714286,656,192,464,2,312.14
Ohio State,2020,7,8,0.875,328,206,122,2,317.06
Ohio State,2021,11,13,0.8461538461538461,594,296,298,14,261.18
Ohio State,2022,11,13,0.8461538461538461,575,273,302,5,295.08
Ohio State,2023,11,13,0.8461538461538461,397,146,251,2,309.49
Oklahoma,2015,11,13,0.8461538461538461,566,286,280,16,241.93
Oklahoma,2016,11,13,0.8461538461538461,571,375,196,14,248.94
Oklahoma,2017,12,14,0.8571428571428571,632,379,253,15,249.69
Oklahoma,2018,12,14,0.8571428571428571,677,466,211,19,238.73
Oklahoma,2019,12,14,0.8571428571428571,590,382,208,8,270.79
Oklahoma,2020,9,11,0.8181818181818182,473,239,234,9,276.62
Oklahoma,2021,11,13,0.8461538461538461,508,335,173,6,279.28
Oklahoma,2022,6,13,0.4615384615384615,427,390,37,11,259.6
Oklahoma,2023,10,13,0.7692307692307693,542,305,237,11,267.92
Oklahoma State,2015,10,13,0.7692307692307693,514,396,118,31,199.52
Oklahoma State,2016,10,13,0.7692307692307693,502,345,157,27,217.59
Oklahoma State,2017,10,13,0.7692307692307693,585,382,203,40,191.28
Oklahoma State,2018,7,13,0.5384615384615384,499,422,77,45,184.33
Oklahoma State,2019,8,13,0.6153846153846154,422,348,74,38,194.18
Oklahoma State,2020,8,11,0.7272727272727273,332,258,74,34,209.93
Oklahoma State,2021,12,14,0.8571428571428571,435,253,182,38,202.09
Oklahoma State,2022,7,13,0.5384615384615384,398,376,22,45,192.35
Oklahoma State,2023,10,14,0.7142857142857143,414,400,14,39,196.26
Old Dominion,2015,5,12,0.4166666666666667,291,429,-138,122,87.47
Old Dominion,2016,10,13,0.7692307692307693,456,354,102,77,136.07
Old Dominion,2017,5,12,0.4166666666666667,248,380,-132,110,115.65
Old Dominion,2018,4,12,0.3333333333333333,370,431,-61,120,106.63
Old Dominion,2019,1,12,0.0833333333333333,195,358,-163,124,99.41
Old Dominion,2021,6,13,0.4615384615384615,359,361,-2,116,128.31
Old Dominion,2022,3,12,0.25,234,319,-85,94,146.75
Old Dominion,2023,6,13,0.4615384615384615,310,353,-43,100,135.74
Ole Miss,2015,10,13,0.7692307692307693,531,294,237,8,275.52
Ole Miss,2016,5,12,0.4166666666666667,391,408,-17,15,241.12
Ole Miss,2017,6,12,0.5,394,415,-21,17,245.71
Ole Miss,2018,5,12,0.4166666666666667,407,434,-27,5,281.69
Ole Miss,2019,4,12,0.3333333333333333,319,318,1,31,207.63
Ole Miss,2020,5,10,0.5,392,383,9,32,211.49
Ole Miss,2021,10,13,0.7692307692307693,438,321,117,22,238.11
Ole Miss,2022,8,13,0.6153846153846154,435,332,103,34,204.07
Ole Miss,2023,11,13,0.8461538461538461,456,293,163,18,234.56
Oregon,2015,9,13,0.6923076923076923,559,488,71,19,227.16
Oregon,2016,4,12,0.3333333333333333,425,497,-72,21,232.44
Oregon,2017,7,13,0.5384615384615384,468,377,91,16,245.79
Oregon,2018,9,13,0.6923076923076923,453,330,123,27,216.42
Oregon,2019,12,14,0.8571428571428571,495,231,264,19,230.04
Oregon,2020,4,7,0.5714285714285714,219,198,21,13,260.22
Oregon,2021,10,14,0.7142857142857143,440,378,62,7,277.98
Oregon,2022,10,13,0.7692307692307693,504,356,148,12,259.49
Oregon,2023,12,14,0.8571428571428571,619,231,388,6,287.38
Oregon State,2015,2,12,0.1666666666666666,228,444,-216,45,186.6
Oregon State,2016,4,12,0.3333333333333333,314,366,-52,60,166.96
Oregon State,2017,1,12,0.0833333333333333,248,516,-268,61,167.89
Oregon State,2018,2,12,0.1666666666666666,313,548,-235,58,169.17
Oregon State,2019,5,12,0.4166666666666667,374,390,-16,51,181.32
Oregon State,2020,2,7,0.2857142857142857,202,233,-31,70,173.14
Oregon State,2021,7,13,0.5384615384615384,406,335,71,66,172.88
Oregon State,2022,10,13,0.7692307692307693,419,260,159,53,182.12
Oregon State,2023,8,13,0.6153846153846154,414,298,116,108,131.45
Penn State,2015,7,13,0.5384615384615384,301,284,17,33,195.7
Penn State,2016,11,14,0.7857142857142857,526,356,170,24,221.35
Penn State,2017,11,13,0.8461538461538461,534,214,320,14,250.0
Penn State,2018,9,13,0.6923076923076923,439,267,172,20,237.79
Penn State,2019,11,13,0.8461538461538461,465,208,257,15,240.47
Penn State,2020,4,9,0.4444444444444444,268,249,19,6,285.92
Penn State,2021,7,13,0.5384615384615384,325,225,100,12,270.67
Penn State,2022,11,13,0.8461538461538461,465,237,228,15,256.05
Penn State,2023,10,13,0.7692307692307693,471,175,296,21,216.43
Pennsylvania,2015,7,10,0.7,329,268,61,139,34.17
Pennsylvania,2016,7,10,0.7,277,213,64,190,13.96
Pennsylvania,2018,6,10,0.6,186,209,-23,158,53.42
Pennsylvania,2019,5,10,0.5,245,298,-53,139,79.22
Pennsylvania,2021,3,10,0.3,191,215,-24,158,54.99
Pennsylvania,2022,8,10,0.8,266,197,69,157,50.08
Pennsylvania,2023,6,10,0.6,255,210,45,139,47.87
Pittsburgh,2015,8,13,0.6153846153846154,367,339,28,32,196.04
Pittsburgh,2016,8,13,0.6153846153846154,532,458,74,44,187.66
Pittsburgh,2017,5,12,0.4166666666666667,287,319,-32,46,183.18
Pittsburgh,2018,7,14,0.5,359,389,-30,30,209.23
Pittsburgh,2019,8,13,0.6153846153846154,275,292,-17,37,202.12
Pittsburgh,2020,6,11,0.5454545454545454,319,270,49,47,193.19
Pittsburgh,2021,11,14,0.7857142857142857,580,331,249,58,181.53
Pittsburgh,2022,9,13,0.6923076923076923,407,316,91,44,192.65
Pittsburgh,2023,3,12,0.25,242,328,-86,26,210.45
Portland State,2015,9,12,0.75,411,268,143,202,6.81
Portland State,2016,2,10,0.2,322,403,-81,133,63.88
Portland State,2017,0,11,0.0,256,473,-217,202,13.29
Portland State,2018,4,11,0.3636363636363636,302,398,-96,167,46.18
Portland State,2019,5,12,0.4166666666666667,416,360,56,173,37.83
Portland State,2020,0,1,0.0,7,48,-41,190,16.74
Portland State,2021,5,11,0.4545454545454545,303,325,-22,110,132.85
Portland State,2022,4,11,0.3636363636363636,282,407,-125,161,41.99
Portland State,2023,5,11,0.4545454545454545,372,359,13,191,7.3
Prairie View A&M,2016,7,11,0.6363636363636364,360,343,17,223,7.93
Prairie View A&M,2017,6,11,0.5454545454545454,330,275,55,187,18.14
Prairie View A&M,2018,5,11,0.4545454545454545,368,297,71,188,29.53
Prairie View A&M,2019,6,11,0.5454545454545454,391,306,85,180,33.37
Prairie View A&M,2020,2,3,0.6666666666666666,68,65,3,178,22.85
Prairie View A&M,2021,7,12,0.5833333333333334,305,315,-10,191,30.85
Prairie View A&M,2023,6,12,0.5,234,374,-140,165,14.18
Presbyterian,2015,2,11,0.1818181818181818,138,223,-85,187,9.99
Presbyterian,2016,2,11,0.1818181818181818,98,340,-242,199,12.63
Presbyterian,2017,4,11,0.3636363636363636,182,325,-143,188,16.93
Presbyterian,2018,2,10,0.2,142,296,-154,215,17.72
Princeton,2016,8,10,0.8,346,164,182,149,30.57
Princeton,2017,5,10,0.5,382,265,117,152,35.28
Princeton,2018,10,10,1.0,470,130,340,173,42.21
Princeton,2019,8,10,0.8,322,181,141,155,56.04
Princeton,2021,9,10,0.9,334,174,160,130,115.29
Princeton,2022,8,10,0.8,278,135,143,124,129.51
Princeton,2023,5,10,0.5,190,168,22,130,69.11
Purdue,2015,2,12,0.1666666666666666,301,438,-137,61,162.05
Purdue,2016,3,12,0.25,295,459,-164,70,156.02
Purdue,2017,7,13,0.5384615384615384,328,267,61,67,162.85
Purdue,2018,6,13,0.4615384615384615,397,390,7,80,145.09
Purdue,2019,4,12,0.3333333333333333,310,367,-57,72,158.89
Purdue,2020,2,6,0.3333333333333333,163,179,-16,52,188.31
Purdue,2021,9,13,0.6923076923076923,378,291,87,25,224.72
Purdue,2022,8,14,0.5714285714285714,372,383,-11,33,208.38
Purdue,2023,4,12,0.3333333333333333,287,365,-78,72,159.72
Rhode Island,2015,1,11,0.0909090909090909,145,329,-184,215,0.0
Rhode Island,2016,2,11,0.1818181818181818,185,400,-215,176,17.0
Rhode Island,2017,3,11,0.2727272727272727,222,300,-78,174,25.89
Rhode Island,2018,6,11,0.5454545454545454,333,310,23,168,46.14
Rhode Island,2020,2,3,0.6666666666666666,78,82,-4,203,12.15
Rhode Island,2021,7,11,0.6363636363636364,277,279,-2,210,20.03
Rhode Island,2022,7,11,0.6363636363636364,337,293,44,152,57.83
Rhode Island,2023,6,11,0.5454545454545454,318,306,12,186,8.92
Rice,2015,5,12,0.4166666666666667,313,430,-117,91,123.22
Rice,2016,3,12,0.25,303,448,-145,91,117.7
Rice,2017,1,12,0.0833333333333333,195,429,-234,101,120.11
Rice,2018,2,13,0.1538461538461538,246,468,-222,129,93.86
Rice,2019,3,12,0.25,215,311,-96,122,101.12
Rice,2020,2,5,0.4,117,94,23,112,120.42
Rice,2021,4,12,0.3333333333333333,258,434,-176,111,132.03
Rice,2022,5,13,0.3846153846153846,328,444,-116,93,147.7
Rice,2023,6,13,0.4615384615384615,384,365,19,93,141.39
Richmond,2015,10,14,0.7142857142857143,462,344,118,144,29.99
Richmond,2016,10,14,0.7142857142857143,401,328,73,170,19.26
Richmond,2017,6,11,0.5454545454545454,340,272,68,195,15.69
Richmond,2018,4,11,0.3636363636363636,243,359,-116,152,57.89
Richmond,2019,5,12,0.4166666666666667,275,333,-58,200,22.7
Richmond,2020,3,4,0.75,96,68,28,221,8.42
Richmond,2021,6,11,0.5454545454545454,264,220,44,177,35.42
Richmond,2022,9,13,0.6923076923076923,407,261,146,229,9.98
Robert Morris,2015,4,11,0.3636363636363636,154,238,-84,216,0.0
Robert Morris,2016,2,11,0.1818181818181818,122,266,-144,211,9.95
Robert Morris,2017,2,11,0.1818181818181818,112,331,-219,197,14.96
Robert Morris,2018,2,11,0.1818181818181818,271,478,-207,204,21.06
Rutgers,2015,4,12,0.3333333333333333,325,419,-94,48,180.79
Rutgers,2016,2,12,0.1666666666666666,188,450,-262,56,174.14
Rutgers,2017,4,12,0.3333333333333333,216,340,-124,56,172.19
Rutgers,2018,1,12,0.0833333333333333,162,377,-215,64,163.8
Rutgers,2019,2,12,0.1666666666666666,159,440,-281,42,189.01
Rutgers,2020,3,9,0.3333333333333333,240,289,-49,56,184.28
Rutgers,2021,5,13,0.3846153846153846,256,333,-77,64,174.33
Rutgers,2022,4,12,0.3333333333333333,209,351,-142,64,170.14
Rutgers,2023,7,13,0.5384615384615384,302,276,26,41,191.67
SE Louisiana,2015,4,11,0.3636363636363636,221,240,-19,169,17.21
SE Louisiana,2016,7,11,0.6363636363636364,319,328,-9,185,14.95
SE Louisiana,2017,6,11,0.5454545454545454,383,282,101,175,24.51
SE Louisiana,2018,4,11,0.3636363636363636,281,369,-88,175,40.99
SE Louisiana,2019,8,13,0.6153846153846154,476,382,94,232,9.03
SE Louisiana,2020,4,7,0.5714285714285714,277,255,22,209,11.11
SE Louisiana,2021,9,13,0.6923076923076923,586,425,161,192,30.71
SE Louisiana,2022,9,13,0.6923076923076923,459,338,121,173,34.04
SMU,2015,2,12,0.1666666666666666,333,548,-215,72,148.4
SMU,2016,5,12,0.4166666666666667,332,435,-103,80,128.23
SMU,2017,7,13,0.5384615384615384,492,477,15,81,142.99
SMU,2018,5,12,0.4166666666666667,365,423,-58,75,152.27
SMU,2019,10,13,0.7692307692307693,544,434,110,80,140.4
SMU,2020,7,10,0.7,386,309,77,87,151.67
SMU,2021,8,12,0.6666666666666666,461,341,120,68,167.28
SMU,2022,7,13,0.5384615384615384,484,440,44,81,156.95
SMU,2023,11,14,0.7857142857142857,542,249,293,53,181.61
Sacramento State,2015,2,11,0.1818181818181818,216,368,-152,142,31.16
Sacramento State,2016,2,10,0.2,237,402,-165,227,6.67
Sacramento State,2017,7,11,0.6363636363636364,414,327,87,231,6.67
Sacramento State,2019,9,13,0.6923076923076923,464,292,172,183,31.33
Sacramento State,2021,9,12,0.75,364,229,135,193,29.38
Sacramento State,2022,12,13,0.9230769230769232,558,337,221,137,89.88
Sacramento State,2023,8,13,0.6153846153846154,397,354,43,161,16.08
Sacred Heart,2018,7,11,0.6363636363636364,309,243,66,231,12.5
Sacred Heart,2019,7,12,0.5833333333333334,295,267,28,251,5.92
Sacred Heart,2020,2,4,0.5,98,65,33,182,19.08
Sam Houston,2015,10,14,0.7142857142857143,582,393,189,164,20.96
Sam Houston,2016,12,13,0.9230769230769232,644,386,258,193,13.29
Sam Houston,2017,12,14,0.8571428571428571,606,437,169,168,29.96
Sam Houston,2018,6,11,0.5454545454545454,330,309,21,140,69.3
Sam Houston,2019,7,12,0.5833333333333334,383,213,170,145,69.78
Sam Houston,2020,10,10,1.0,375,196,179,173,25.16
Sam Houston,2021,11,12,0.9166666666666666,492,257,235,163,48.49
Sam Houston,2022,5,9,0.5555555555555556,165,187,-22,184,26.54
Sam Houston,2023,3,12,0.25,240,314,-74,167,13.67
Samford,2015,6,11,0.5454545454545454,381,294,87,133,46.1
Samford,2016,7,12,0.5833333333333334,421,327,94,144,34.42
Samford,2017,8,12,0.6666666666666666,336,267,69,143,37.8
Samford,2018,6,11,0.5454545454545454,423,290,133,146,64.62
Samford,2019,5,12,0.4166666666666667,387,453,-66,203,21.72
Samford,2020,4,7,0.5714285714285714,282,191,91,195,15.4
Samford,2021,4,11,0.3636363636363636,417,434,-17,213,18.9
Samford,2022,11,13,0.8461538461538461,420,328,92,196,21.2
Samford,2023,6,11,0.5454545454545454,319,267,52,148,28.48
San Diego,2018,9,12,0.75,454,350,104,205,20.91
San Diego,2019,9,12,0.75,462,271,191,246,6.67
San Diego,2021,7,11,0.6363636363636364,283,277,6,198,27.37
San Diego,2022,5,11,0.4545454545454545,279,210,69,182,27.65
San Diego,2023,4,11,0.3636363636363636,253,277,-24,184,9.32
San Diego State,2015,11,14,0.7857142857142857,450,230,220,69,151.17
San Diego State,2016,11,14,0.7857142857142857,493,283,210,73,147.92
San Diego State,2017,10,13,0.7692307692307693,400,263,137,70,161.96
San Diego State,2018,7,13,0.5384615384615384,268,288,-20,82,141.93
San Diego State,2019,10,13,0.7692307692307693,276,165,111,77,149.69
San Diego State,2020,4,8,0.5,197,142,55,79,159.56
San Diego State,2021,12,14,0.8571428571428571,383,277,106,91,149.19
San Diego State,2022,7,13,0.5384615384615384,279,267,12,104,142.57
San Diego State,2023,4,12,0.3333333333333333,246,321,-75,62,169.98
San José State,2015,6,13,0.4615384615384615,363,354,9,123,83.62
San José State,2016,4,12,0.3333333333333333,293,416,-123,83,124.98
San José State,2017,2,13,0.1538461538461538,206,542,-336,62,167.14
San José State,2018,1,12,0.0833333333333333,255,439,-184,84,137.84
San José State,2019,5,12,0.4166666666666667,361,383,-22,98,122.11
San José State,2020,7,8,0.875,229,159,70,94,140.86
San José State,2021,5,12,0.4166666666666667,240,318,-78,118,127.53
San José State,2022,7,12,0.5833333333333334,329,264,65,114,137.42
San José State,2023,7,13,0.5384615384615384,414,333,81,120,112.81
Savannah St,2016,3,10,0.3,143,308,-165,187,14.24
Savannah St,2017,3,11,0.2727272727272727,214,347,-133,263,0.0
Savannah St,2018,2,10,0.2,134,293,-159,202,24.24
Savannah St,2019,0,2,0.0,36,66,-30,162,49.86
Savannah St,2020,0,1,0.0,28,36,-8,211,10.04
South Alabama,2015,5,12,0.4166666666666667,300,447,-147,92,123.16
South Alabama,2016,6,13,0.4615384615384615,330,351,-21,115,96.08
South Alabama,2017,4,12,0.3333333333333333,238,318,-80,88,132.17
South Alabama,2018,3,12,0.25,290,465,-175,87,134.08
South Alabama,2019,2,12,0.1666666666666666,221,368,-147,116,110.24
South Alabama,2020,4,11,0.3636363636363636,219,300,-81,115,120.03
South Alabama,2021,5,12,0.4166666666666667,299,317,-18,126,122.8
South Alabama,2022,10,13,0.7692307692307693,406,277,129,109,140.54
South Alabama,2023,7,13,0.5384615384615384,430,273,157,122,107.68
South Carolina,2015,3,12,0.25,263,330,-67,20,224.01
South Carolina,2016,6,13,0.4615384615384615,270,344,-74,19,239.33
South Carolina,2017,9,13,0.6923076923076923,315,269,46,20,230.49
South Carolina,2018,7,13,0.5384615384615384,391,354,37,25,216.77
South Carolina,2019,4,12,0.3333333333333333,269,313,-44,21,227.58
South Carolina,2020,2,10,0.2,235,360,-125,18,242.04
South Carolina,2021,7,13,0.5384615384615384,294,312,-18,17,247.26
South Carolina,2022,8,13,0.6153846153846154,418,375,43,18,250.12
South Carolina,2023,5,12,0.4166666666666667,312,316,-4,76,157.05
South Carolina State,2015,7,11,0.6363636363636364,294,167,127,131,50.71
South Carolina State,2016,5,11,0.4545454545454545,232,254,-22,141,40.82
South Carolina State,2017,3,10,0.3,205,188,17,149,36.33
South Carolina State,2018,5,11,0.4545454545454545,215,268,-53,192,27.65
South Carolina State,2019,8,11,0.7272727272727273,331,223,108,228,9.98
South Carolina State,2020,3,4,0.75,69,75,-6,241,3.97
South Dakota,2015,5,11,0.4545454545454545,231,280,-49,209,6.67
South Dakota,2016,4,11,0.3636363636363636,329,379,-50,233,6.64
South Dakota,2017,8,13,0.6153846153846154,496,344,152,145,37.56
South Dakota,2018,4,11,0.3636363636363636,294,376,-82,159,49.75
South Dakota,2019,5,12,0.4166666666666667,363,389,-26,146,69.54
South Dakota,2020,1,4,0.25,71,96,-25,184,17.69
South Dakota,2021,7,12,0.5833333333333334,324,248,76,200,24.59
South Dakota,2022,3,11,0.2727272727272727,179,321,-142,176,29.87
South Dakota,2023,10,13,0.7692307692307693,312,230,82,151,25.25
South Dakota State,2015,8,12,0.6666666666666666,341,208,133,185,10.0
South Dakota State,2016,9,13,0.6923076923076923,431,355,76,175,17.23
South Dakota State,2017,11,14,0.7857142857142857,521,335,186,158,33.71
South Dakota State,2018,10,13,0.7692307692307693,553,290,263,149,61.31
South Dakota State,2019,8,13,0.6153846153846154,386,217,169,144,70.87
South Dakota State,2020,8,10,0.8,292,150,142,237,4.97
South Dakota State,2021,11,15,0.7333333333333333,542,296,246,214,17.82
South Dakota State,2022,14,15,0.9333333333333332,512,237,275,194,22.07
South Florida,2015,8,13,0.6153846153846154,437,298,139,54,173.74
South Florida,2016,11,13,0.8461538461538461,569,411,158,42,189.74
South Florida,2017,10,12,0.8333333333333334,459,282,177,66,163.15
South Florida,2018,7,13,0.5384615384615384,370,416,-46,66,161.21
South Florida,2019,4,12,0.3333333333333333,250,347,-97,76,150.65
South Florida,2020,1,9,0.1111111111111111,208,359,-151,65,176.25
South Florida,2021,2,12,0.1666666666666666,278,416,-138,77,158.44
South Florida,2022,1,12,0.0833333333333333,336,494,-158,101,142.97
South Florida,2023,7,13,0.5384615384615384,415,419,-4,63,167.63
Southeast Missouri State,2015,4,11,0.3636363636363636,279,299,-20,207,6.67
Southeast Missouri State,2016,3,11,0.2727272727272727,229,268,-39,161,23.39
Southeast Missouri State,2017,3,11,0.2727272727272727,225,240,-15,148,36.75
Southeast Missouri State,2018,9,13,0.6923076923076923,482,403,79,157,55.17
Southeast Missouri State,2019,9,13,0.6923076923076923,358,324,34,179,33.67
Southeast Missouri State,2020,4,8,0.5,221,181,40,222,8.02
Southeast Missouri State,2021,4,11,0.3636363636363636,297,341,-44,201,24.44
Southeast Missouri State,2022,9,12,0.75,427,271,156,233,8.97
Southern,2015,6,10,0.6,339,322,17,160,21.62
Southern,2016,8,11,0.7272727272727273,438,311,127,286,-0.03
Southern,2018,7,11,0.6363636363636364,311,277,34,194,26.44
Southern,2019,8,13,0.6153846153846154,427,338,89,218,12.97
Southern,2021,4,11,0.3636363636363636,290,339,-49,162,51.2
Southern Illinois,2015,3,11,0.2727272727272727,397,381,16,151,25.26
Southern Illinois,2016,4,11,0.3636363636363636,340,338,2,139,41.96
Southern Illinois,2017,4,11,0.3636363636363636,301,302,-1,146,37.12
Southern Illinois,2018,2,11,0.1818181818181818,331,448,-117,217,16.63
Southern Illinois,2019,7,12,0.5833333333333334,339,276,63,137,79.79
Southern Illinois,2020,6,10,0.6,271,297,-26,143,69.52
Southern Illinois,2021,8,13,0.6153846153846154,402,336,66,194,29.2
Southern Illinois,2022,5,11,0.4545454545454545,311,294,17,230,9.91
Southern Illinois,2023,8,13,0.6153846153846154,332,210,122,172,12.65
Southern Miss,2015,9,14,0.6428571428571429,559,358,201,82,136.46
Southern Miss,2016,7,13,0.5384615384615384,427,384,43,82,125.74
Southern Miss,2017,8,13,0.6153846153846154,379,318,61,87,133.4
Southern Miss,2018,6,11,0.5454545454545454,288,218,70,100,126.05
Southern Miss,2019,7,13,0.5384615384615384,346,341,5,74,152.71
Southern Miss,2020,3,10,0.3,253,323,-70,80,157.89
Southern Miss,2021,3,12,0.25,212,335,-123,82,156.39
Southern Miss,2022,7,13,0.5384615384615384,329,306,23,76,161.52
Southern Miss,2023,3,12,0.25,278,429,-151,124,104.36
Southern Utah,2017,9,12,0.75,403,336,67,234,5.98
Southern Utah,2018,1,11,0.0909090909090909,281,456,-175,177,38.01
Southern Utah,2019,3,12,0.25,295,451,-156,154,56.45
Southern Utah,2020,1,6,0.1666666666666666,159,164,-5,150,44.53
Southern Utah,2021,1,11,0.0909090909090909,209,432,-223,155,58.28
Southern Utah,2023,6,11,0.5454545454545454,350,261,89,153,24.64
St. Francis (PA),2016,7,12,0.5833333333333334,323,238,85,280,-0.03
St. Francis (PA),2017,5,11,0.4545454545454545,241,161,80,196,15.51
St. Francis (PA),2019,6,12,0.5,302,261,41,212,14.94
Stanford,2015,12,14,0.8571428571428571,529,316,213,52,175.38
Stanford,2016,10,13,0.7692307692307693,342,265,77,13,250.05
Stanford,2017,9,14,0.6428571428571429,453,318,135,24,220.65
Stanford,2018,9,13,0.6923076923076923,369,298,71,16,245.82
Stanford,2019,4,12,0.3333333333333333,260,358,-98,14,246.79
Stanford,2020,4,6,0.6666666666666666,176,190,-14,40,202.29
Stanford,2021,3,12,0.25,245,389,-144,21,242.58
Stanford,2022,3,12,0.25,256,386,-130,21,238.62
Stanford,2023,3,12,0.25,247,452,-205,51,183.58
Stephen F. Austin,2015,4,10,0.4,288,328,-40,162,21.18
Stephen F. Austin,2016,5,11,0.4545454545454545,334,422,-88,228,6.67
Stephen F. Austin,2017,4,11,0.3636363636363636,216,325,-109,138,41.3
Stephen F. Austin,2018,2,10,0.2,181,333,-152,134,79.35
Stephen F. Austin,2019,3,12,0.25,289,419,-130,153,56.96
Stephen F. Austin,2020,6,10,0.6,259,224,35,148,50.86
Stephen F. Austin,2021,8,12,0.6666666666666666,411,232,179,131,113.58
Stephen F. Austin,2022,6,11,0.5454545454545454,377,340,37,142,77.21
Stephen F. Austin,2023,3,11,0.2727272727272727,322,349,-27,144,36.77
Stetson,2015,3,11,0.2727272727272727,237,346,-109,197,7.98
Stetson,2019,7,11,0.6363636363636364,352,288,64,211,15.21
Stony Brook,2015,5,10,0.5,173,157,16,167,19.72
Stony Brook,2016,5,11,0.4545454545454545,184,222,-38,143,35.51
Stony Brook,2017,10,13,0.7692307692307693,380,268,112,227,7.82
Stony Brook,2018,7,12,0.5833333333333334,322,244,78,197,25.36
Stony Brook,2019,5,12,0.4166666666666667,292,328,-36,159,51.96
Stony Brook,2020,1,4,0.25,56,89,-33,161,31.48
Stony Brook,2021,5,11,0.4545454545454545,233,252,-19,202,24.3
Stony Brook,2022,2,11,0.1818181818181818,166,355,-189,192,22.7
Syracuse,2015,4,12,0.3333333333333333,327,372,-45,74,144.37
Syracuse,2016,4,12,0.3333333333333333,308,463,-155,52,176.87
Syracuse,2017,4,12,0.3333333333333333,329,386,-57,57,172.06
Syracuse,2018,10,13,0.7692307692307693,523,351,172,62,165.15
Syracuse,2019,5,12,0.4166666666666667,339,368,-29,54,180.08
Syracuse,2020,1,11,0.0909090909090909,196,360,-164,51,189.14
Syracuse,2021,5,12,0.4166666666666667,299,316,-17,55,182.67
Syracuse,2022,7,13,0.5384615384615384,360,300,60,59,175.88
Syracuse,2023,6,13,0.4615384615384615,306,330,-24,57,176.5
TCU,2015,11,13,0.8461538461538461,547,354,193,35,194.83
TCU,2016,6,13,0.4615384615384615,403,364,39,43,188.64
TCU,2017,11,14,0.7857142857142857,470,266,204,39,191.44
TCU,2018,7,13,0.5384615384615384,306,300,6,21,235.79
TCU,2019,5,12,0.4166666666666667,364,317,47,28,210.03
TCU,2020,6,10,0.6,308,242,66,25,224.13
TCU,2021,5,12,0.4166666666666667,344,419,-75,33,210.62
TCU,2022,13,15,0.8666666666666667,582,435,147,28,215.88
TCU,2023,5,12,0.4166666666666667,376,334,42,61,171.83
Temple,2015,10,14,0.7142857142857143,417,281,136,77,140.29
Temple,2016,10,14,0.7142857142857143,453,258,195,69,156.27
Temple,2017,7,13,0.5384615384615384,326,335,-9,80,143.34
Temple,2018,8,13,0.6153846153846154,454,352,102,59,167.55
Temple,2019,8,13,0.6153846153846154,342,337,5,119,108.13
Temple,2020,1,7,0.1428571428571428,139,260,-121,83,155.39
Temple,2021,3,12,0.25,196,450,-254,105,136.56
Temple,2022,3,12,0.25,263,351,-88,97,145.3
Temple,2023,3,12,0.25,253,428,-175,105,132.83
Tennessee,2015,9,13,0.6923076923076923,457,260,197,25,214.06
Tennessee,2016,9,13,0.6923076923076923,473,375,98,7,274.77
Tennessee,2017,4,12,0.3333333333333333,238,349,-111,4,286.26
Tennessee,2018,5,12,0.4166666666666667,273,335,-62,14,253.94
Tennessee,2019,8,13,0.6153846153846154,314,282,32,17,237.21
Tennessee,2020,3,10,0.3,215,301,-86,21,231.34
Tennessee,2021,7,13,0.5384615384615384,511,378,133,13,269.07
Tennessee,2022,11,13,0.8461538461538461,599,296,303,10,261.5
Tennessee,2023,9,13,0.6923076923076923,413,264,149,16,240.4
Tennessee State,2015,4,10,0.4,246,281,-35,143,30.63
Tennessee State,2016,7,11,0.6363636363636364,355,331,24,153,26.59
Tennessee State,2017,6,11,0.5454545454545454,267,216,51,228,7.57
Tennessee State,2018,4,9,0.4444444444444444,264,289,-25,133,81.09
Tennessee State,2019,3,12,0.25,314,415,-101,169,40.82
Tennessee State,2020,2,7,0.2857142857142857,129,214,-85,157,34.68
Tennessee State,2021,5,11,0.4545454545454545,217,296,-79,183,33.09
Tennessee State,2022,4,11,0.3636363636363636,201,272,-71,175,32.21
Tennessee State,2023,6,11,0.5454545454545454,250,265,-15,170,13.15
Tennessee Tech,2015,4,11,0.3636363636363636,254,395,-141,132,47.01
Tennessee Tech,2016,5,11,0.4545454545454545,296,316,-20,145,32.99
Tennessee Tech,2017,1,11,0.0909090909090909,174,325,-151,186,19.23
Tennessee Tech,2018,1,11,0.0909090909090909,198,507,-309,160,49.02
Tennessee Tech,2019,6,12,0.5,348,422,-74,186,30.13
Tennessee Tech,2020,2,7,0.2857142857142857,140,186,-46,144,60.57
Tennessee Tech,2021,3,11,0.2727272727272727,202,350,-148,247,4.96
Tennessee Tech,2023,4,11,0.3636363636363636,182,278,-96,156,21.96
Texas,2015,5,12,0.4166666666666667,317,364,-47,17,234.52
Texas,2016,5,12,0.4166666666666667,383,378,5,17,239.85
Texas,2017,7,13,0.5384615384615384,383,276,107,10,272.49
Texas,2018,10,14,0.7142857142857143,435,362,73,7,280.66
Texas,2019,8,13,0.6153846153846154,458,357,101,25,217.76
Texas,2020,7,10,0.7,427,285,142,3,300.06
Texas,2021,5,12,0.4166666666666667,423,373,50,3,287.69
Texas,2022,8,13,0.6153846153846154,448,281,167,9,270.93
Texas,2023,12,14,0.8571428571428571,501,265,236,17,237.09
Texas A&M,2015,8,13,0.6153846153846154,361,286,75,9,267.75
Texas A&M,2016,8,13,0.6153846153846154,453,319,134,5,278.08
Texas A&M,2017,7,13,0.5384615384615384,425,399,26,11,270.61
Texas A&M,2018,9,13,0.6923076923076923,468,329,139,18,238.94
Texas A&M,2019,8,13,0.6153846153846154,384,293,91,13,248.58
Texas A&M,2020,9,10,0.9,326,217,109,17,251.2
Texas A&M,2021,8,12,0.6666666666666666,352,191,161,4,285.46
Texas A&M,2022,5,12,0.4166666666666667,273,254,19,6,289.49
Texas A&M,2023,7,13,0.5384615384615384,433,287,146,7,285.35
Texas Southern,2015,2,8,0.25,177,283,-106,212,3.33
Texas Southern,2016,4,11,0.3636363636363636,256,304,-48,245,1.97
Texas Southern,2017,2,11,0.1818181818181818,182,322,-140,180,21.52
Texas Southern,2018,1,10,0.1,185,349,-164,248,6.67
Texas Southern,2019,0,11,0.0,241,500,-259,161,51.76
Texas Southern,2020,1,3,0.3333333333333333,44,71,-27,192,16.3
Texas Southern,2021,2,10,0.2,290,397,-107,156,56.43
Texas Southern,2022,5,11,0.4545454545454545,281,285,-4,236,8.97
Texas Southern,2023,3,11,0.2727272727272727,288,360,-72,177,11.04
Texas State,2015,3,12,0.25,323,470,-147,94,120.48
Texas State,2016,2,12,0.1666666666666666,223,493,-270,97,109.9
Texas State,2017,2,12,0.1666666666666666,207,403,-196,95,124.71
Texas State,2018,3,12,0.25,237,331,-94,110,111.71
Texas State,2019,3,12,0.25,221,391,-170,92,127.89
Texas State,2020,2,12,0.1666666666666666,332,458,-126,107,124.24
Texas State,2021,4,12,0.3333333333333333,277,396,-119,133,111.1
Texas State,2022,4,12,0.3333333333333333,253,316,-63,99,145.19
Texas State,2023,8,13,0.6153846153846154,477,427,50,183,9.46
Texas Tech,2015,7,13,0.5384615384615384,586,567,19,46,182.16
Texas Tech,2016,5,12,0.4166666666666667,524,522,2,40,191.82
Texas Tech,2017,6,13,0.4615384615384615,446,419,27,32,203.18
Texas Tech,2018,5,12,0.4166666666666667,448,373,75,44,184.64
Texas Tech,2019,4,12,0.3333333333333333,366,364,2,49,183.07
Texas Tech,2020,4,10,0.4,291,367,-76,72,169.87
Texas Tech,2021,7,13,0.5384615384615384,394,392,2,61,177.69
Texas Tech,2022,8,13,0.6153846153846154,445,379,66,49,183.17
Texas Tech,2023,7,13,0.5384615384615384,356,338,18,64,167.13
The Citadel,2015,9,13,0.6923076923076923,400,283,117,161,21.42
The Citadel,2016,10,12,0.8333333333333334,317,246,71,178,16.76
The Citadel,2017,5,11,0.4545454545454545,237,290,-53,166,30.4
The Citadel,2018,5,11,0.4545454545454545,328,333,-5,243,7.67
The Citadel,2019,6,12,0.5,346,338,8,187,29.98
The Citadel,2020,2,12,0.1666666666666666,194,360,-166,175,24.53
The Citadel,2021,4,11,0.3636363636363636,271,378,-107,216,17.36
Toledo,2015,10,12,0.8333333333333334,420,249,171,76,141.96
Toledo,2016,9,13,0.6923076923076923,494,334,160,92,115.38
Toledo,2017,11,14,0.7857142857142857,509,367,142,84,138.12
Toledo,2018,7,13,0.5384615384615384,525,397,128,88,132.92
Toledo,2019,6,12,0.5,327,386,-59,78,146.6
Toledo,2020,4,6,0.6666666666666666,210,146,64,67,174.0
Toledo,2021,7,13,0.5384615384615384,434,283,151,73,162.01
Toledo,2022,9,14,0.6428571428571429,438,351,87,69,164.2
Toledo,2023,11,14,0.7857142857142857,452,284,168,67,163.18
Towson,2015,7,11,0.6363636363636364,260,236,24,188,9.94
Towson,2016,4,11,0.3636363636363636,243,304,-61,162,21.77
Towson,2017,5,11,0.4545454545454545,192,263,-71,134,47.49
Towson,2018,7,12,0.5833333333333334,414,346,68,179,37.47
Towson,2019,7,12,0.5833333333333334,363,282,81,205,18.5
Towson,2023,5,11,0.4545454545454545,264,356,-92,178,10.54
Troy,2015,4,12,0.3333333333333333,335,339,-4,99,114.51
Troy,2016,10,13,0.7692307692307693,438,287,151,132,64.21
Troy,2017,11,13,0.8461538461538461,410,240,170,117,107.58
Troy,2018,10,13,0.7692307692307693,399,286,113,98,127.73
Troy,2019,5,12,0.4166666666666667,406,417,-11,96,123.9
Troy,2020,5,11,0.4545454545454545,301,283,18,98,136.65
Troy,2021,5,12,0.4166666666666667,274,313,-39,80,157.59
Troy,2022,12,14,0.8571428571428571,358,240,118,84,154.47
Troy,2023,11,14,0.7857142857142857,415,240,175,104,133.65
Tulane,2015,3,12,0.25,236,435,-199,83,133.37
Tulane,2016,4,12,0.3333333333333333,289,332,-43,90,118.86
Tulane,2017,5,12,0.4166666666666667,330,350,-20,91,128.9
Tulane,2018,7,13,0.5384615384615384,349,358,-9,97,127.78
Tulane,2019,7,13,0.5384615384615384,430,342,88,112,114.66
Tulane,2020,6,12,0.5,416,337,79,68,173.75
Tulane,2021,2,12,0.1666666666666666,331,408,-77,94,144.82
Tulane,2022,12,14,0.8571428571428571,504,311,193,66,165.84
Tulane,2023,11,14,0.7857142857142857,369,287,82,77,156.56
Tulsa,2015,6,13,0.4615384615384615,483,518,-35,81,138.11
Tulsa,2016,10,13,0.7692307692307693,552,388,164,79,130.3
Tulsa,2017,2,12,0.1666666666666666,352,450,-98,109,116.08
Tulsa,2018,3,12,0.25,289,355,-66,95,128.52
Tulsa,2019,4,12,0.3333333333333333,317,376,-59,85,135.07
Tulsa,2020,6,9,0.6666666666666666,244,194,50,97,137.25
Tulsa,2021,7,13,0.5384615384615384,343,346,-3,109,133.88
Tulsa,2022,5,12,0.4166666666666667,367,397,-30,112,138.25
Tulsa,2023,4,12,0.3333333333333333,281,406,-125,126,97.89
UAB,2017,8,13,0.6153846153846154,361,333,28,264,0.0
UAB,2018,11,14,0.7857142857142857,418,238,180,71,158.61
UAB,2019,9,14,0.6428571428571429,324,302,22,108,115.95
UAB,2020,6,9,0.6666666666666666,256,193,63,103,125.49
UAB,2021,9,13,0.6923076923076923,384,302,82,74,160.48
UAB,2022,7,13,0.5384615384615384,391,301,90,103,142.57
UAB,2023,4,12,0.3333333333333333,359,443,-84,116,123.44
UAlbany,2015,3,11,0.2727272727272727,165,315,-150,141,32.8
UAlbany,2016,7,11,0.6363636363636364,274,207,67,138,42.37
UAlbany,2017,4,11,0.3636363636363636,191,195,-4,268,-0.06
UAlbany,2018,3,11,0.2727272727272727,232,337,-105,198,25.3
UAlbany,2019,9,14,0.6428571428571429,439,357,82,204,20.4
UAlbany,2021,2,11,0.1818181818181818,208,288,-80,236,8.92
UAlbany,2023,11,15,0.7333333333333333,426,297,129,189,7.31
UC Davis,2015,2,11,0.1818181818181818,245,376,-131,193,8.98
UC Davis,2016,3,11,0.2727272727272727,310,408,-98,152,27.34
UC Davis,2017,5,11,0.4545454545454545,370,354,16,140,39.45
UC Davis,2018,10,13,0.7692307692307693,516,356,160,141,69.2
UC Davis,2019,5,12,0.4166666666666667,344,352,-8,157,54.27
UC Davis,2020,3,5,0.6,166,118,48,153,39.09
UC Davis,2021,8,12,0.6666666666666666,340,273,67,141,90.14
UC Davis,2022,6,11,0.5454545454545454,395,239,156,136,93.33
UC Davis,2023,7,11,0.6363636363636364,283,269,14,145,31.22
UCF,2015,0,12,0.0,167,452,-285,79,139.32
UCF,2016,6,13,0.4615384615384615,374,320,54,68,159.55
UCF,2017,13,13,1.0,627,329,298,71,160.78
UCF,2018,12,13,0.9230769230769232,562,295,267,65,162.22
UCF,2019,10,13,0.7692307692307693,564,299,265,55,178.34
UCF,2020,6,10,0.6,422,332,90,62,177.05
UCF,2021,9,13,0.6923076923076923,415,319,96,59,179.69
UCF,2022,9,14,0.6428571428571429,460,331,129,71,162.97
UCF,2023,6,13,0.4615384615384615,407,335,72,55,177.69
UCLA,2015,8,13,0.6153846153846154,419,338,81,7,276.33
UCLA,2016,4,12,0.3333333333333333,299,330,-31,18,239.74
UCLA,2017,6,13,0.4615384615384615,422,476,-54,12,269.68
UCLA,2018,3,12,0.25,288,409,-121,13,259.06
UCLA,2019,4,12,0.3333333333333333,320,417,-97,20,229.13
UCLA,2020,3,7,0.4285714285714285,248,215,33,19,237.77
UCLA,2021,8,12,0.6666666666666666,438,321,117,40,199.61
UCLA,2022,9,13,0.6923076923076923,510,377,133,32,208.42
UCLA,2023,8,13,0.6153846153846154,344,239,105,29,206.5
UConn,2015,6,13,0.4615384615384615,223,253,-30,62,160.61
UConn,2016,3,12,0.25,178,337,-159,110,98.31
UConn,2017,3,12,0.25,283,455,-172,99,120.89
UConn,2018,1,12,0.0833333333333333,266,605,-339,99,126.83
UConn,2019,2,12,0.1666666666666666,227,486,-259,101,121.64
UConn,2021,1,12,0.0833333333333333,187,462,-275,117,127.68
UConn,2022,6,13,0.4615384615384615,252,341,-89,118,134.27
UConn,2023,3,12,0.25,229,358,-129,115,125.11
UL Monroe,2015,2,13,0.1538461538461538,273,475,-202,126,77.32
UL Monroe,2016,4,12,0.3333333333333333,280,469,-189,126,84.48
UL Monroe,2017,4,12,0.3333333333333333,407,492,-85,108,116.67
UL Monroe,2018,6,12,0.5,319,381,-62,124,99.51
UL Monroe,2019,5,12,0.4166666666666667,379,464,-85,102,121.55
UL Monroe,2020,0,10,0.0,163,420,-257,118,116.57
UL Monroe,2021,4,12,0.3333333333333333,251,402,-151,128,119.38
UL Monroe,2022,4,12,0.3333333333333333,268,413,-145,120,132.3
UL Monroe,2023,2,12,0.1666666666666666,208,419,-211,113,127.64
UNLV,2015,3,12,0.25,343,404,-61,98,117.06
UNLV,2016,4,12,0.3333333333333333,379,441,-62,117,91.15
UNLV,2017,5,12,0.4166666666666667,346,381,-35,106,119.46
UNLV,2018,4,12,0.3333333333333333,345,447,-102,81,142.78
UNLV,2019,4,12,0.3333333333333333,290,396,-106,117,109.9
UNLV,2020,0,6,0.0,104,228,-124,99,131.08
UNLV,2021,2,12,0.1666666666666666,249,394,-145,100,139.57
UNLV,2022,5,12,0.4166666666666667,316,342,-26,77,160.84
UNLV,2023,9,14,0.6428571428571429,482,400,82,68,161.89
USC,2015,8,14,0.5714285714285714,475,360,115,13,256.44
USC,2016,10,13,0.7692307692307693,447,315,132,10,264.86
USC,2017,11,14,0.7857142857142857,456,366,90,2,310.88
USC,2018,5,12,0.4166666666666667,313,324,-11,10,273.71
USC,2019,8,13,0.6153846153846154,422,382,40,4,297.1
USC,2020,5,6,0.8333333333333334,200,156,44,4,291.2
USC,2021,4,12,0.3333333333333333,344,381,-37,20,243.51
USC,2022,11,14,0.7857142857142857,579,409,170,55,181.01
USC,2023,8,13,0.6153846153846154,544,447,97,8,280.72
UT Martin,2015,7,11,0.6363636363636364,390,370,20,194,8.82
UT Martin,2016,7,12,0.5833333333333334,387,288,99,206,10.84
UT Martin,2017,6,11,0.5454545454545454,216,157,59,139,39.72
UT Martin,2018,2,11,0.1818181818181818,318,378,-60,233,11.94
UT Martin,2019,7,12,0.5833333333333334,307,299,8,163,49.44
UT Martin,2020,3,7,0.4285714285714285,175,154,21,145,58.52
UT Martin,2021,10,13,0.7692307692307693,390,325,65,157,55.08
UT Martin,2022,7,11,0.6363636363636364,382,331,51,186,24.03
UTEP,2015,5,12,0.4166666666666667,248,395,-147,121,88.53
UTEP,2016,4,12,0.3333333333333333,316,419,-103,118,89.53
UTEP,2017,0,12,0.0,141,441,-300,128,73.03
UTEP,2018,1,12,0.0833333333333333,212,393,-181,125,99.39
UTEP,2019,1,12,0.0833333333333333,235,431,-196,133,85.51
UTEP,2020,3,8,0.375,184,248,-64,129,105.24
UTEP,2021,7,13,0.5384615384615384,326,328,-2,112,131.98
UTEP,2022,5,12,0.4166666666666667,293,324,-31,131,114.47
UTEP,2023,3,12,0.25,239,342,-103,134,60.62
UTSA,2015,3,12,0.25,271,405,-134,103,108.72
UTSA,2016,6,13,0.4615384615384615,379,363,16,127,81.73
UTSA,2017,6,11,0.5454545454545454,259,187,72,103,119.88
UTSA,2018,3,12,0.25,170,374,-204,103,120.32
UTSA,2019,4,12,0.3333333333333333,244,407,-163,75,151.48
UTSA,2020,7,12,0.5833333333333334,339,308,31,85,152.98
UTSA,2021,12,14,0.8571428571428571,516,345,171,96,142.31
UTSA,2022,11,14,0.7857142857142857,515,363,152,105,142.53
UTSA,2023,9,13,0.6923076923076923,415,313,102,78,154.8
Utah,2015,10,13,0.7692307692307693,398,290,108,47,181.27
Utah,2016,9,13,0.6923076923076923,388,311,77,66,160.67
Utah,2017,7,13,0.5384615384615384,384,301,83,45,183.38
Utah,2018,9,14,0.6428571428571429,393,272,121,37,200.66
Utah,2019,11,14,0.7857142857142857,452,210,242,33,205.78
Utah,2020,3,5,0.6,151,130,21,33,209.95
Utah,2021,10,14,0.7142857142857143,506,316,190,42,196.61
Utah,2022,10,14,0.7142857142857143,541,300,241,29,212.32
Utah,2023,8,13,0.6153846153846154,301,251,50,33,203.23
Utah State,2015,6,13,0.4615384615384615,377,347,30,109,105.41
Utah State,2016,3,12,0.25,287,352,-65,111,97.8
Utah State,2017,6,13,0.4615384615384615,392,350,42,96,124.56
Utah State,2018,11,13,0.8461538461538461,618,289,329,92,130.65
Utah State,2019,7,13,0.5384615384615384,380,399,-19,104,120.0
Utah State,2020,1,6,0.1666666666666666,93,211,-118,109,123.61
Utah State,2021,11,14,0.7857142857142857,456,342,114,90,149.92
Utah State,2022,6,13,0.4615384615384615,289,405,-116,117,134.5
Utah State,2023,6,13,0.4615384615384615,431,451,-20,135,55.32
VMI,2015,2,11,0.1818181818181818,254,385,-131,177,13.93
VMI,2016,3,11,0.2727272727272727,224,305,-81,301,-0.09
VMI,2018,1,11,0.0909090909090909,257,530,-273,206,20.11
VMI,2019,5,12,0.4166666666666667,370,453,-83,238,6.81
VMI,2020,6,8,0.75,234,174,60,227,7.98
VMI,2022,1,11,0.0909090909090909,177,399,-222,200,20.05
Valparaiso,2017,6,11,0.5454545454545454,330,313,17,214,10.32
Vanderbilt,2015,4,12,0.3333333333333333,182,252,-70,26,211.23
Vanderbilt,2016,6,13,0.4615384615384615,299,312,-13,46,183.05
Vanderbilt,2017,5,12,0.4166666666666667,295,376,-81,49,181.37
Vanderbilt,2018,6,13,0.4615384615384615,370,346,24,54,171.54
Vanderbilt,2019,3,12,0.25,198,381,-183,65,167.42
Vanderbilt,2020,0,9,0.0,133,336,-203,41,202.04
Vanderbilt,2021,2,12,0.1666666666666666,189,430,-241,56,182.42
Vanderbilt,2022,5,12,0.4166666666666667,295,432,-137,52,182.21
Vanderbilt,2023,2,12,0.1666666666666666,274,434,-160,49,184.46
Villanova,2015,6,11,0.5454545454545454,231,202,29,156,22.47
Villanova,2016,9,13,0.6923076923076923,317,195,122,202,11.66
Villanova,2017,5,11,0.4545454545454545,231,177,54,156,34.1
Villanova,2018,5,11,0.4545454545454545,275,257,18,186,30.97
Villanova,2019,9,13,0.6923076923076923,485,339,146,141,73.85
Villanova,2020,2,4,0.5,117,97,20,187,16.91
Villanova,2021,10,13,0.7692307692307693,391,217,174,189,30.97
Villanova,2022,6,11,0.5454545454545454,289,313,-24,145,69.37
Villanova,2023,10,13,0.7692307692307693,415,245,170,179,10.53
Virginia,2015,4,12,0.3333333333333333,309,386,-77,29,201.88
Virginia,2016,2,12,0.1666666666666666,270,405,-135,33,205.34
Virginia,2017,6,13,0.4615384615384615,293,369,-76,50,179.92
Virginia,2018,8,13,0.6153846153846154,370,261,109,63,164.95
Virginia,2019,9,14,0.6428571428571429,449,380,69,58,172.5
Virginia,2020,5,10,0.5,307,296,11,59,178.6
Virginia,2021,6,12,0.5,415,382,33,39,200.89
Virginia,2022,3,10,0.3,170,240,-70,48,185.57
Virginia,2023,3,12,0.25,279,405,-126,31,205.33
Virginia Tech,2015,7,13,0.5384615384615384,403,342,61,21,223.82
Virginia Tech,2016,10,14,0.7142857142857143,490,319,171,28,217.39
Virginia Tech,2017,9,13,0.6923076923076923,366,192,174,29,212.07
Virginia Tech,2018,6,13,0.4615384615384615,388,403,-15,42,190.06
Virginia Tech,2019,8,13,0.6153846153846154,401,321,80,26,217.74
Virginia Tech,2020,5,11,0.4545454545454545,342,353,-11,24,226.01
Virginia Tech,2021,6,13,0.4615384615384615,308,329,-21,26,224.01
Virginia Tech,2022,3,11,0.2727272727272727,212,272,-60,72,162.89
Virginia Tech,2023,7,13,0.5384615384615384,384,311,73,45,189.84
Wagner,2015,1,11,0.0909090909090909,157,397,-240,179,13.06
Wagner,2016,6,11,0.5454545454545454,287,232,55,283,-0.03
Wagner,2018,4,11,0.3636363636363636,308,437,-129,261,0.0
Wagner,2020,0,2,0.0,7,44,-37,238,4.97
Wake Forest,2015,3,12,0.25,209,295,-86,65,153.0
Wake Forest,2016,7,13,0.5384615384615384,265,288,-23,67,160.4
Wake Forest,2017,8,13,0.6153846153846154,459,368,91,51,176.85
Wake Forest,2018,7,13,0.5384615384615384,427,433,-6,57,169.4
Wake Forest,2019,8,13,0.6153846153846154,414,378,36,68,161.99
Wake Forest,2020,4,9,0.4444444444444444,324,295,29,64,176.31
Wake Forest,2021,11,14,0.7857142857142857,574,404,170,57,182.26
Wake Forest,2022,8,13,0.6153846153846154,469,368,101,60,173.82
Wake Forest,2023,4,12,0.3333333333333333,243,326,-83,66,165.75
Washington,2015,7,13,0.5384615384615384,398,244,154,18,234.2
Washington,2016,12,14,0.8571428571428571,585,248,337,38,198.52
Washington,2017,10,13,0.7692307692307693,471,209,262,26,215.83
Washington,2018,10,14,0.7142857142857143,369,229,140,29,209.87
Washington,2019,8,13,0.6153846153846154,416,252,164,22,224.74
Washington,2020,3,4,0.75,121,100,21,16,253.23
Washington,2021,4,12,0.3333333333333333,258,272,-14,15,259.19
Washington,2022,11,13,0.8461538461538461,516,336,180,16,252.35
Washington,2023,14,15,0.9333333333333332,540,372,168,35,201.78
Washington State,2015,9,13,0.6923076923076923,409,360,49,50,177.9
Washington State,2016,8,13,0.6153846153846154,496,343,153,53,176.62
Washington State,2017,9,13,0.6923076923076923,394,335,59,42,188.41
Washington State,2018,11,13,0.8461538461538461,488,303,185,56,169.74
Washington State,2019,6,13,0.4615384615384615,491,408,83,44,186.45
Washington State,2020,1,4,0.25,108,154,-46,46,194.84
Washington State,2021,7,13,0.5384615384615384,362,315,47,65,174.14
Washington State,2022,7,13,0.5384615384615384,339,298,41,56,179.28
Washington State,2023,5,12,0.4166666666666667,380,337,43,60,172.58
Weber State,2015,6,11,0.5454545454545454,247,270,-23,203,6.67
Weber State,2017,11,14,0.7857142857142857,472,246,226,151,35.75
Weber State,2018,10,13,0.7692307692307693,362,275,87,161,48.18
Weber State,2019,11,15,0.7333333333333333,417,312,105,149,64.24
Weber State,2020,5,6,0.8333333333333334,165,122,43,160,31.5
Weber State,2021,6,11,0.5454545454545454,344,215,129,171,39.26
West Virginia,2015,8,13,0.6153846153846154,442,320,122,30,201.03
West Virginia,2016,10,13,0.7692307692307693,405,312,93,39,194.85
West Virginia,2017,7,13,0.5384615384615384,449,409,40,35,198.02
West Virginia,2018,8,12,0.6666666666666666,483,326,157,39,194.45
West Virginia,2019,5,12,0.4166666666666667,247,346,-99,57,174.68
West Virginia,2020,6,10,0.6,265,205,60,35,208.32
West Virginia,2021,6,13,0.4615384615384615,328,310,18,48,191.83
West Virginia,2022,5,12,0.4166666666666667,367,395,-28,37,199.77
West Virginia,2023,9,13,0.6923076923076923,409,340,69,40,195.07
Western Carolina,2015,7,11,0.6363636363636364,301,304,-3,198,7.83
Western Carolina,2016,2,11,0.1818181818181818,265,396,-131,208,10.5
Western Carolina,2017,7,12,0.5833333333333334,389,325,64,137,43.67
Western Carolina,2018,3,11,0.2727272727272727,347,451,-104,162,47.73
Western Carolina,2019,3,12,0.25,217,465,-248,189,28.39
Western Carolina,2020,1,9,0.1111111111111111,147,359,-212,165,28.54
Western Carolina,2021,4,11,0.3636363636363636,356,454,-98,152,65.38
Western Carolina,2022,6,11,0.5454545454545454,351,351,0,177,29.45
Western Carolina,2023,7,11,0.6363636363636364,399,298,101,173,12.61
Western Illinois,2015,7,13,0.5384615384615384,327,386,-59,206,6.67
Western Illinois,2016,6,11,0.5454545454545454,319,346,-27,183,15.51
Western Illinois,2017,8,12,0.6666666666666666,410,266,144,169,28.88
Western Illinois,2018,5,11,0.4545454545454545,263,286,-23,234,11.29
Western Illinois,2019,1,12,0.0833333333333333,224,443,-219,176,36.02
Western Illinois,2020,1,6,0.1666666666666666,120,197,-77,186,16.91
Western Illinois,2022,0,11,0.0,150,426,-276,188,23.72
Western Kentucky,2015,12,14,0.8571428571428571,620,363,257,95,120.24
Western Kentucky,2016,11,14,0.7857142857142857,637,344,293,88,121.12
Western Kentucky,2017,6,13,0.4615384615384615,331,349,-18,111,115.65
Western Kentucky,2018,3,12,0.25,253,334,-81,101,124.1
Western Kentucky,2019,9,13,0.6923076923076923,330,261,69,82,138.03
Western Kentucky,2020,5,12,0.4166666666666667,228,304,-76,84,154.77
Western Kentucky,2021,9,14,0.6428571428571429,619,411,208,86,153.89
Western Kentucky,2022,9,14,0.6428571428571429,510,328,182,80,157.37
Western Kentucky,2023,8,13,0.6153846153846154,396,373,23,136,49.62
Western Michigan,2015,8,13,0.6153846153846154,468,368,100,108,106.64
Western Michigan,2016,13,14,0.9285714285714286,582,277,305,71,153.42
Western Michigan,2017,6,12,0.5,407,348,59,76,147.78
Western Michigan,2018,7,13,0.5384615384615384,416,449,-33,67,160.72
Western Michigan,2019,7,13,0.5384615384615384,430,337,93,89,129.94
Western Michigan,2020,4,6,0.6666666666666666,250,205,45,76,163.69
Western Michigan,2021,8,13,0.6153846153846154,422,367,55,92,148.7
Western Michigan,2022,5,12,0.4166666666666667,228,289,-61,86,153.11
Western Michigan,2023,4,12,0.3333333333333333,284,381,-97,97,139.11
William & Mary,2015,9,13,0.6923076923076923,402,295,107,182,11.99
William & Mary,2016,5,11,0.4545454545454545,243,259,-16,174,18.18
William & Mary,2017,2,11,0.1818181818181818,165,263,-98,157,33.75
William & Mary,2018,4,10,0.4,136,262,-126,191,27.71
William & Mary,2019,5,12,0.4166666666666667,303,338,-35,172,39.61
William & Mary,2020,1,3,0.3333333333333333,55,69,-14,208,11.15
William & Mary,2021,6,11,0.5454545454545454,245,243,2,221,15.95
William & Mary,2023,6,11,0.5454545454545454,239,204,35,168,13.3
Wisconsin,2015,10,13,0.7692307692307693,348,178,170,40,191.08
Wisconsin,2016,11,14,0.7857142857142857,397,218,179,32,205.44
Wisconsin,2017,13,14,0.9285714285714286,473,195,278,41,189.85
Wisconsin,2018,8,13,0.6153846153846154,386,294,92,35,202.85
Wisconsin,2019,10,14,0.7142857142857143,477,237,240,39,193.87
Wisconsin,2020,4,7,0.5714285714285714,176,122,54,45,195.04
Wisconsin,2021,9,13,0.6923076923076923,330,210,120,29,219.51
Wisconsin,2022,7,13,0.5384615384615384,342,263,79,25,225.54
Wisconsin,2023,7,13,0.5384615384615384,305,262,43,15,240.8
Wofford,2015,5,11,0.4545454545454545,284,305,-21,168,18.4
Wofford,2016,10,14,0.7142857142857143,375,239,136,154,26.57
Wofford,2017,10,13,0.7692307692307693,334,291,43,167,30.13
Wofford,2018,9,13,0.6923076923076923,385,247,138,164,46.72
Wofford,2019,8,12,0.6666666666666666,387,265,122,207,17.5
Wofford,2020,1,5,0.2,130,139,-9,217,8.91
Wofford,2021,1,11,0.0909090909090909,225,380,-155,190,30.95
Wofford,2022,3,11,0.2727272727272727,220,350,-130,203,19.41
Wofford,2023,2,11,0.1818181818181818,152,278,-126,193,5.8
Wyoming,2015,2,12,0.1666666666666666,228,408,-180,110,101.61
Wyoming,2016,8,14,0.5714285714285714,503,477,26,128,80.87
Wyoming,2017,8,13,0.6153846153846154,305,228,77,113,114.32
Wyoming,2018,6,12,0.5,248,264,-16,116,109.65
Wyoming,2019,8,13,0.6153846153846154,330,231,99,99,122.05
Wyoming,2020,2,6,0.3333333333333333,159,126,33,126,109.14
Wyoming,2021,7,13,0.5384615384615384,330,308,22,97,140.75
Wyoming,2022,7,13,0.5384615384615384,276,311,-35,113,138.13
Wyoming,2023,9,13,0.6923076923076923,329,290,39,110,130.41
Yale,2015,6,10,0.6,235,242,-7,129,70.19
Yale,2016,3,10,0.3,203,339,-136,104,103.87
Yale,2017,9,10,0.9,345,156,189,136,45.08
Yale,2018,5,10,0.5,295,285,10,122,102.29
Yale,2019,9,10,0.9,387,262,125,127,95.54
Yale,2021,5,10,0.5,299,247,52,134,110.17
Yale,2022,8,10,0.8,305,195,110,147,66.61
Yale,2023,7,10,0.7,299,199,100,133,61.37
Youngstown State,2015,5,11,0.4545454545454545,323,254,69,192,9.05
Youngstown State,2016,12,16,0.75,442,319,123,173,18.81
Youngstown State,2017,6,11,0.5454545454545454,327,210,117,183,21.21
Youngstown State,2018,4,11,0.3636363636363636,254,299,-45,166,46.34
Youngstown State,2019,6,12,0.5,365,321,44,199,24.07
Youngstown State,2020,1,7,0.1428571428571428,108,153,-45,174,25.11
Youngstown State,2021,3,10,0.3,247,354,-107,225,13.33
Youngstown State,2022,7,11,0.6363636363636364,314,279,35,183,27.25
