team,year,win,points_scored,points_allowed,games_played,win_pct,point_diff
Abilene Christian,2015,3,258,316,10,0.3,-58
Abilene Christian,2016,2,295,417,11,0.18181818181818182,-122
Abilene Christian,2017,2,209,321,11,0.18181818181818182,-112
Abilene Christian,2018,6,331,296,11,0.5454545454545454,35
Abilene Christian,2019,5,336,343,12,0.4166666666666667,-7
Abilene Christian,2020,1,124,213,6,0.16666666666666666,-89
Abilene Christian,2021,5,311,280,11,0.45454545454545453,31
Abilene Christian,2022,7,310,246,11,0.6363636363636364,64
Abilene Christian,2023,5,286,319,11,0.45454545454545453,-33
Adams State,2021,1,273,461,11,0.09090909090909091,-188
Adams State,2022,2,251,417,11,0.18181818181818182,-166
Adams State,2023,3,187,433,11,0.2727272727272727,-246
Adrian,2020,2,106,115,4,0.5,-9
Adrian,2022,6,296,188,10,0.6,108
Adrian,2023,1,191,321,10,0.1,-130
Air Force,2015,8,473,357,14,0.5714285714285714,116
Air Force,2016,10,457,341,13,0.7692307692307693,116
Air Force,2017,5,377,389,12,0.4166666666666667,-12
Air Force,2018,5,362,309,12,0.4166666666666667,53
Air Force,2019,11,443,258,13,0.8461538461538461,185
Air Force,2020,3,146,90,6,0.5,56
Air Force,2021,10,403,257,13,0.7692307692307693,146
Air Force,2022,10,362,174,13,0.7692307692307693,188
Air Force,2023,9,362,236,13,0.6923076923076923,126
Akron,2015,8,311,279,13,0.6153846153846154,32
Akron,2016,5,329,403,12,0.4166666666666667,-74
Akron,2017,7,310,392,14,0.5,-82
Akron,2018,4,227,326,12,0.3333333333333333,-99
Akron,2019,0,126,435,12,0.0,-309
Akron,2020,1,103,248,6,0.16666666666666666,-145
Akron,2021,2,238,474,12,0.16666666666666666,-236
Akron,2022,2,261,402,12,0.16666666666666666,-141
Akron,2023,2,195,336,12,0.16666666666666666,-141
Alabama,2015,14,526,227,15,0.9333333333333333,299
Alabama,2016,14,582,195,15,0.9333333333333333,387
Alabama,2017,13,519,167,14,0.9285714285714286,352
Alabama,2018,14,684,271,15,0.9333333333333333,413
Alabama,2019,11,614,242,13,0.8461538461538461,372
Alabama,2020,13,630,252,13,1.0,378
Alabama,2021,13,598,302,15,0.8666666666666667,296
Alabama,2022,11,534,236,13,0.8461538461538461,298
Alabama,2023,12,476,266,14,0.8571428571428571,210
Alabama A&M,2015,3,203,375,10,0.3,-172
Alabama A&M,2016,4,262,426,11,0.36363636363636365,-164
Alabama A&M,2017,4,193,292,11,0.36363636363636365,-99
Alabama A&M,2018,5,273,256,10,0.5,17
Alabama A&M,2019,7,409,398,12,0.5833333333333334,11
Alabama A&M,2020,5,163,97,5,1.0,66
Alabama A&M,2021,7,379,351,10,0.7,28
Alabama A&M,2022,4,225,353,11,0.36363636363636365,-128
Alabama A&M,2023,5,326,301,11,0.45454545454545453,25
Alabama State,2015,5,235,258,10,0.5,-23
Alabama State,2016,4,286,301,11,0.36363636363636365,-15
Alabama State,2017,5,154,198,11,0.45454545454545453,-44
Alabama State,2018,3,143,387,10,0.3,-244
Alabama State,2019,5,249,301,11,0.45454545454545453,-52
Alabama State,2020,3,121,121,6,0.5,0
Alabama State,2021,5,240,310,11,0.45454545454545453,-70
Alabama State,2022,6,207,223,11,0.5454545454545454,-16
Alabama State,2023,7,227,159,11,0.6363636363636364,68
Albany State GA,2021,9,301,75,11,0.8181818181818182,226
Albany State GA,2022,7,296,149,10,0.7,147
Albany State GA,2023,6,268,235,11,0.5454545454545454,33
Albion,2020,3,111,57,3,1.0,54
Albion,2022,9,381,141,10,0.9,240
Albion,2023,7,322,210,10,0.7,112
Albright,2020,1,34,65,2,0.5,-31
Albright,2022,0,124,309,10,0.0,-185
Albright,2023,0,65,378,10,0.0,-313
Alcorn State,2015,8,441,253,11,0.7272727272727273,188
Alcorn State,2016,5,333,319,11,0.45454545454545453,14
Alcorn State,2017,7,372,261,12,0.5833333333333334,111
Alcorn State,2018,9,426,279,13,0.6923076923076923,147
Alcorn State,2019,9,437,300,13,0.6923076923076923,137
Alcorn State,2020,0,0,12,6,0.0,-12
Alcorn State,2021,6,286,284,11,0.5454545454545454,2
Alcorn State,2022,5,228,274,11,0.45454545454545453,-46
Alcorn State,2023,7,246,247,11,0.6363636363636364,-1
Alderson-Broaddus,2015,0,18,53,1,0.0,-35
Alderson-Broaddus,2016,1,14,7,1,1.0,7
Alderson-Broaddus,2020,0,12,127,3,0.0,-115
Alderson-Broaddus,2021,1,133,423,11,0.09090909090909091,-290
Alderson-Broaddus,2022,0,168,471,11,0.0,-303
Alderson-Broaddus,2023,0,0,0,11,0.0,0
Alfred State,2022,5,283,288,10,0.5,-5
Alfred State,2023,6,335,281,11,0.5454545454545454,54
Alfred University,2020,1,34,40,2,0.5,-6
Alfred University,2022,2,136,329,10,0.2,-193
Alfred University,2023,4,155,227,10,0.4,-72
Allegheny,2022,2,200,356,9,0.2222222222222222,-156
Allegheny,2023,3,206,263,10,0.3,-57
Allen,2021,3,218,305,8,0.375,-87
Allen,2022,1,238,328,10,0.1,-90
Allen,2023,7,325,264,10,0.7,61
Alma,2020,1,19,21,2,0.5,-2
Alma,2022,11,472,240,12,0.9166666666666666,232
Alma,2023,12,609,259,13,0.9230769230769231,350
American International,2015,0,3,27,1,0.0,-24
American International,2021,4,191,244,10,0.4,-53
American International,2022,1,147,312,10,0.1,-165
American International,2023,3,173,364,11,0.2727272727272727,-191
Amherst,2022,2,108,169,9,0.2222222222222222,-61
Amherst,2023,4,126,215,9,0.4444444444444444,-89
Anderson (IN),2020,1,179,208,5,0.2,-29
Anderson (IN),2022,1,84,429,10,0.1,-345
Anderson (IN),2023,0,98,553,10,0.0,-455
Angelo State,2018,0,24,41,1,0.0,-17
Angelo State,2020,1,46,52,2,0.5,-6
Angelo State,2021,11,502,230,14,0.7857142857142857,272
Angelo State,2022,12,417,178,13,0.9230769230769231,239
Angelo State,2023,7,314,174,10,0.7,140
Anna Maria College,2022,5,295,301,9,0.5555555555555556,-6
Anna Maria College,2023,5,358,329,9,0.5555555555555556,29
App State,2015,11,477,248,13,0.8461538461538461,229
App State,2016,10,380,232,13,0.7692307692307693,148
App State,2017,9,435,263,13,0.6923076923076923,172
App State,2018,11,485,201,13,0.8461538461538461,284
App State,2019,13,543,280,14,0.9285714285714286,263
App State,2020,9,406,240,12,0.75,166
App State,2021,10,483,310,14,0.7142857142857143,173
App State,2022,6,419,321,12,0.5,98
App State,2023,9,465,378,14,0.6428571428571429,87
Apprentice School,2022,0,19,22,1,0.0,-3
Apprentice School,2023,1,88,114,4,0.25,-26
Arizona,2015,7,486,465,13,0.5384615384615384,21
Arizona,2016,3,297,460,12,0.25,-163
Arizona,2017,7,537,447,13,0.5384615384615384,90
Arizona,2018,5,376,391,12,0.4166666666666667,-15
Arizona,2019,4,323,429,12,0.3333333333333333,-106
Arizona,2020,0,87,199,5,0.0,-112
Arizona,2021,1,206,377,12,0.08333333333333333,-171
Arizona,2022,5,370,438,12,0.4166666666666667,-68
Arizona,2023,10,450,274,13,0.7692307692307693,176
Arizona State,2015,6,450,435,13,0.46153846153846156,15
Arizona State,2016,5,400,478,12,0.4166666666666667,-78
Arizona State,2017,7,414,427,13,0.5384615384615384,-13
Arizona State,2018,7,389,332,13,0.5384615384615384,57
Arizona State,2019,8,322,291,13,0.6153846153846154,31
Arizona State,2020,2,161,93,4,0.5,68
Arizona State,2021,8,369,271,13,0.6153846153846154,98
Arizona State,2022,3,313,377,12,0.25,-64
Arizona State,2023,3,213,382,12,0.25,-169
Arkansas,2015,8,467,356,13,0.6153846153846154,111
Arkansas,2016,7,394,404,13,0.5384615384615384,-10
Arkansas,2017,4,345,434,12,0.3333333333333333,-89
Arkansas,2018,2,260,417,12,0.16666666666666666,-157
Arkansas,2019,2,257,442,12,0.16666666666666666,-185
Arkansas,2020,3,257,349,10,0.3,-92
Arkansas,2021,9,402,298,13,0.6923076923076923,104
Arkansas,2022,7,423,398,13,0.5384615384615384,25
Arkansas,2023,4,319,335,12,0.3333333333333333,-16
Arkansas State,2015,9,520,393,13,0.6923076923076923,127
Arkansas State,2016,8,355,279,13,0.6153846153846154,76
Arkansas State,2017,7,454,309,12,0.5833333333333334,145
Arkansas State,2018,8,394,333,13,0.6153846153846154,61
Arkansas State,2019,8,438,444,13,0.6153846153846154,-6
Arkansas State,2020,4,362,409,11,0.36363636363636365,-47
Arkansas State,2021,2,303,463,12,0.16666666666666666,-160
Arkansas State,2022,3,300,377,12,0.25,-77
Arkansas State,2023,6,352,395,13,0.46153846153846156,-43
Arkansas Tech,2021,4,289,333,11,0.36363636363636365,-44
Arkansas Tech,2022,5,308,380,11,0.45454545454545453,-72
Arkansas Tech,2023,5,212,285,11,0.45454545454545453,-73
Arkansas-Monticello,2021,5,259,389,11,0.45454545454545453,-130
Arkansas-Monticello,2022,3,269,338,11,0.2727272727272727,-69
Arkansas-Monticello,2023,2,262,401,11,0.18181818181818182,-139
Arkansas-Pine Bluff,2015,2,206,394,10,0.2,-188
Arkansas-Pine Bluff,2016,1,150,464,11,0.09090909090909091,-314
Arkansas-Pine Bluff,2017,2,231,379,11,0.18181818181818182,-148
Arkansas-Pine Bluff,2018,2,248,441,10,0.2,-193
Arkansas-Pine Bluff,2019,6,349,304,11,0.5454545454545454,45
Arkansas-Pine Bluff,2020,4,174,139,5,0.8,35
Arkansas-Pine Bluff,2021,2,218,415,11,0.18181818181818182,-197
Arkansas-Pine Bluff,2022,3,262,395,11,0.2727272727272727,-133
Arkansas-Pine Bluff,2023,2,167,372,11,0.18181818181818182,-205
Army,2015,2,265,334,12,0.16666666666666666,-69
Army,2016,8,389,258,13,0.6153846153846154,131
Army,2017,10,399,286,13,0.7692307692307693,113
Army,2018,11,426,230,13,0.8461538461538461,196
Army,2019,5,370,299,13,0.38461538461538464,71
Army,2020,9,321,178,12,0.75,143
Army,2021,9,427,290,13,0.6923076923076923,137
Army,2022,6,343,270,12,0.5,73
Army,2023,6,246,253,12,0.5,-7
Ashland,2021,5,301,259,10,0.5,42
Ashland,2022,10,351,176,12,0.8333333333333334,175
Ashland,2023,8,341,244,11,0.7272727272727273,97
Assumption,2021,5,266,255,10,0.5,11
Assumption,2022,7,178,146,10,0.7,32
Assumption,2023,5,209,235,10,0.5,-26
Auburn,2015,7,357,338,13,0.5384615384615384,19
Auburn,2016,8,406,222,13,0.6153846153846154,184
Auburn,2017,10,474,259,14,0.7142857142857143,215
Auburn,2018,8,402,249,13,0.6153846153846154,153
Auburn,2019,9,432,254,13,0.6923076923076923,178
Auburn,2020,6,276,272,11,0.5454545454545454,4
Auburn,2021,6,368,283,13,0.46153846153846156,85
Auburn,2022,5,297,354,12,0.4166666666666667,-57
Auburn,2023,6,340,294,13,0.46153846153846156,46
Augsburg,2020,1,24,21,1,1.0,3
Augsburg,2022,6,303,228,9,0.6666666666666666,75
Augsburg,2023,6,352,254,10,0.6,98
Augustana (IL),2020,1,85,66,3,0.3333333333333333,19
Augustana (IL),2022,5,348,330,10,0.5,18
Augustana (IL),2023,8,376,229,10,0.8,147
Augustana University (SD),2021,9,459,257,12,0.75,202
Augustana University (SD),2022,7,290,228,11,0.6363636363636364,62
Augustana University (SD),2023,11,425,260,13,0.8461538461538461,165
Aurora,2020,3,127,50,3,1.0,77
Aurora,2022,11,599,216,13,0.8461538461538461,383
Aurora,2023,11,639,167,12,0.9166666666666666,472
Austin,2020,1,102,145,4,0.25,-43
Austin,2022,1,129,301,10,0.1,-172
Austin,2023,1,139,368,10,0.1,-229
Austin Peay,2015,0,133,429,11,0.0,-296
Austin Peay,2016,0,259,517,11,0.0,-258
Austin Peay,2017,8,327,297,12,0.6666666666666666,30
Austin Peay,2018,5,340,337,11,0.45454545454545453,3
Austin Peay,2019,11,518,309,15,0.7333333333333333,209
Austin Peay,2020,4,215,301,9,0.4444444444444444,-86
Austin Peay,2021,6,358,274,11,0.5454545454545454,84
Austin Peay,2022,7,347,250,11,0.6363636363636364,97
Austin Peay,2023,9,402,284,12,0.75,118
Ave Maria University,2015,0,21,60,1,0.0,-39
Ave Maria University,2019,0,28,42,1,0.0,-14
Ave Maria University,2021,0,16,49,1,0.0,-33
Ave Maria University,2022,0,14,42,1,0.0,-28
Ave Maria University,2023,1,27,14,1,1.0,13
Averett,2020,1,66,83,3,0.3333333333333333,-17
Averett,2022,3,120,263,9,0.3333333333333333,-143
Averett,2023,5,271,275,10,0.5,-4
Azusa Pacific,2018,0,35,37,1,0.0,-2
BLUEFIELD,2016,0,7,59,1,0.0,-52
BLUEFIELD,2018,0,10,41,1,0.0,-31
BLUEFIELD,2022,0,33,41,1,0.0,-8
BYU,2015,9,438,297,13,0.6923076923076923,141
BYU,2016,9,384,254,13,0.6923076923076923,130
BYU,2017,4,222,321,13,0.3076923076923077,-99
BYU,2018,7,354,278,13,0.5384615384615384,76
BYU,2019,7,370,331,13,0.5384615384615384,39
BYU,2020,11,522,184,12,0.9166666666666666,338
BYU,2021,10,430,322,13,0.7692307692307693,108
BYU,2022,8,407,383,13,0.6153846153846154,24
BYU,2023,5,277,358,12,0.4166666666666667,-81
Bacone College,2015,0,3,129,2,0.0,-126
Bacone College,2016,0,6,84,1,0.0,-78
Bacone College,2017,0,17,34,1,0.0,-17
Baldwin Wallace,2020,0,37,58,2,0.0,-21
Baldwin Wallace,2022,7,276,209,10,0.7,67
Baldwin Wallace,2023,6,311,283,10,0.6,28
Ball State,2015,3,277,430,12,0.25,-153
Ball State,2016,4,324,361,12,0.3333333333333333,-37
Ball State,2017,2,215,488,12,0.16666666666666666,-273
Ball State,2018,4,290,389,12,0.3333333333333333,-99
Ball State,2019,5,418,377,12,0.4166666666666667,41
Ball State,2020,7,274,206,8,0.875,68
Ball State,2021,6,313,369,13,0.46153846153846156,-56
Ball State,2022,5,279,323,12,0.4166666666666667,-44
Ball State,2023,4,219,293,12,0.3333333333333333,-74
Bates,2022,3,171,309,9,0.3333333333333333,-138
Bates,2023,0,105,318,9,0.0,-213
Baylor,2015,10,625,368,13,0.7692307692307693,257
Baylor,2016,7,450,377,13,0.5384615384615384,73
Baylor,2017,1,292,431,12,0.08333333333333333,-139
Baylor,2018,7,384,412,13,0.5384615384615384,-28
Baylor,2019,11,471,277,14,0.7857142857142857,194
Baylor,2020,2,210,263,9,0.2222222222222222,-53
Baylor,2021,12,443,256,14,0.8571428571428571,187
Baylor,2022,6,418,349,13,0.46153846153846156,69
Baylor,2023,3,277,400,12,0.25,-123
Belhaven,2020,3,108,133,5,0.6,-25
Belhaven,2022,8,383,158,10,0.8,225
Belhaven,2023,9,394,180,11,0.8181818181818182,214
Beloit,2022,1,169,401,10,0.1,-232
Beloit,2023,2,163,395,10,0.2,-232
Bemidji State,2021,10,445,411,13,0.7692307692307693,34
Bemidji State,2022,10,482,233,13,0.7692307692307693,249
Bemidji State,2023,9,366,207,12,0.75,159
Benedict College,2016,0,0,45,1,0.0,-45
Benedict College,2021,5,258,234,10,0.5,24
Benedict College,2022,11,421,155,12,0.9166666666666666,266
Benedict College,2023,11,483,128,12,0.9166666666666666,355
Benedictine University,2020,2,96,64,3,0.6666666666666666,32
Benedictine University,2022,7,399,209,10,0.7,190
Benedictine University,2023,5,221,229,9,0.5555555555555556,-8
Bentley,2021,9,333,233,11,0.8181818181818182,100
Bentley,2022,7,260,105,10,0.7,155
Bentley,2023,6,251,138,10,0.6,113
Berry College,2020,4,119,67,4,1.0,52
Berry College,2022,7,353,148,10,0.7,205
Berry College,2023,9,542,163,10,0.9,379
Bethany (KS),2015,0,7,51,1,0.0,-44
Bethany (WV),2020,1,67,84,3,0.3333333333333333,-17
Bethany (WV),2022,1,106,339,9,0.1111111111111111,-233
Bethany (WV),2023,0,148,377,10,0.0,-229
Bethel (MN),2022,10,423,234,12,0.8333333333333334,189
Bethel (MN),2023,8,322,162,11,0.7272727272727273,160
Bethel Col,2021,0,9,52,1,0.0,-43
Bethel University Tennessee,2015,0,10,72,1,0.0,-62
Bethel University Tennessee,2019,0,16,65,1,0.0,-49
Bethel University Tennessee,2021,0,14,48,1,0.0,-34
Bethune-Cookman,2015,9,345,275,11,0.8181818181818182,70
Bethune-Cookman,2016,4,252,252,10,0.4,0
Bethune-Cookman,2017,7,228,263,11,0.6363636363636364,-35
Bethune-Cookman,2018,7,359,365,12,0.5833333333333334,-6
Bethune-Cookman,2019,7,268,285,11,0.6363636363636364,-17
Bethune-Cookman,2021,2,270,399,11,0.18181818181818182,-129
Bethune-Cookman,2022,2,259,434,11,0.18181818181818182,-175
Bethune-Cookman,2023,3,203,286,11,0.2727272727272727,-83
Biddeford,2022,5,218,257,10,0.5,-39
Biddeford,2023,6,293,254,10,0.6,39
Birmingham-Southern,2020,2,132,99,4,0.5,33
Birmingham-Southern,2022,7,289,145,10,0.7,144
Birmingham-Southern,2023,3,125,274,10,0.3,-149
Black Hills State,2015,0,0,55,1,0.0,-55
Black Hills State,2021,2,195,315,9,0.2222222222222222,-120
Black Hills State,2022,7,310,230,11,0.6363636363636364,80
Black Hills State,2023,6,336,351,11,0.5454545454545454,-15
Bloomsburg,2021,3,208,337,11,0.2727272727272727,-129
Bloomsburg,2022,3,216,270,11,0.2727272727272727,-54
Bloomsburg,2023,3,165,233,11,0.2727272727272727,-68
Bluefield State,2021,3,118,155,6,0.5,-37
Bluefield State,2022,3,149,218,8,0.375,-69
Bluefield State,2023,1,196,358,10,0.1,-162
Bluffton,2020,3,193,220,7,0.42857142857142855,-27
Bluffton,2022,2,227,430,10,0.2,-203
Bluffton,2023,4,302,307,10,0.4,-5
Boise State,2015,9,508,263,13,0.6923076923076923,245
Boise State,2016,10,439,303,13,0.7692307692307693,136
Boise State,2017,11,455,320,14,0.7857142857142857,135
Boise State,2018,10,460,287,13,0.7692307692307693,173
Boise State,2019,12,486,306,14,0.8571428571428571,180
Boise State,2020,5,237,190,7,0.7142857142857143,47
Boise State,2021,7,350,228,12,0.5833333333333334,122
Boise State,2022,10,413,273,14,0.7142857142857143,140
Boise State,2023,8,450,358,14,0.5714285714285714,92
Boston College,2015,3,206,183,12,0.25,23
Boston College,2016,7,265,325,13,0.5384615384615384,-60
Boston College,2017,7,334,297,13,0.5384615384615384,37
Boston College,2018,7,384,308,12,0.5833333333333334,76
Boston College,2019,6,377,418,13,0.46153846153846156,-41
Boston College,2020,6,306,312,11,0.5454545454545454,-6
Boston College,2021,6,296,266,12,0.5,30
Boston College,2022,3,213,364,12,0.25,-151
Boston College,2023,7,323,368,13,0.5384615384615384,-45
Bowdoin,2022,3,158,204,9,0.3333333333333333,-46
Bowdoin,2023,4,227,224,9,0.4444444444444444,3
Bowie State,2015,0,14,21,1,0.0,-7
Bowie State,2016,0,35,44,1,0.0,-9
Bowie State,2018,0,23,40,1,0.0,-17
Bowie State,2021,12,452,206,14,0.8571428571428571,246
Bowie State,2022,6,289,233,10,0.6,56
Bowie State,2023,6,214,233,10,0.6,-19
Bowling Green,2015,10,591,405,14,0.7142857142857143,186
Bowling Green,2016,4,298,460,12,0.3333333333333333,-162
Bowling Green,2017,2,304,456,12,0.16666666666666666,-152
Bowling Green,2018,3,292,480,12,0.25,-188
Bowling Green,2019,3,192,463,12,0.25,-271
Bowling Green,2020,0,57,225,5,0.0,-168
Bowling Green,2021,4,257,368,12,0.3333333333333333,-111
Bowling Green,2022,6,305,423,13,0.46153846153846156,-118
Bowling Green,2023,7,340,312,13,0.5384615384615384,28
Brevard College,2015,0,7,55,1,0.0,-48
Brevard College,2017,0,7,30,1,0.0,-23
Brevard College,2018,0,13,34,1,0.0,-21
Brevard College,2020,4,122,56,5,0.8,66
Brevard College,2021,0,14,38,1,0.0,-24
Brevard College,2022,5,175,217,9,0.5555555555555556,-42
Brevard College,2023,5,302,281,10,0.5,21
Bridgewater (VA),2020,2,84,81,4,0.5,3
Bridgewater (VA),2022,9,344,181,10,0.9,163
Bridgewater (VA),2023,7,330,244,10,0.7,86
Bridgewater State,2022,6,317,231,10,0.6,86
Bridgewater State,2023,7,301,180,10,0.7,121
Brockport,2022,7,242,137,10,0.7,105
Brockport,2023,8,374,98,10,0.8,276
Brown,2015,5,279,329,10,0.5,-50
Brown,2016,4,204,265,10,0.4,-61
Brown,2017,2,130,301,10,0.2,-171
Brown,2018,1,143,362,10,0.1,-219
Brown,2019,2,300,402,10,0.2,-102
Brown,2021,2,295,424,10,0.2,-129
Brown,2022,3,231,351,10,0.3,-120
Brown,2023,5,255,290,10,0.5,-35
Bryant,2015,5,297,250,11,0.45454545454545453,47
Bryant,2016,5,316,310,11,0.45454545454545453,6
Bryant,2017,6,333,382,11,0.5454545454545454,-49
Bryant,2018,6,357,446,11,0.5454545454545454,-89
Bryant,2019,4,199,325,12,0.3333333333333333,-126
Bryant,2020,2,70,58,4,0.5,12
Bryant,2021,7,330,249,11,0.6363636363636364,81
Bryant,2022,4,366,331,11,0.36363636363636365,35
Bryant,2023,6,343,287,11,0.5454545454545454,56
Bucknell,2015,4,172,206,11,0.36363636363636365,-34
Bucknell,2016,4,232,263,11,0.36363636363636365,-31
Bucknell,2017,5,185,249,11,0.45454545454545453,-64
Bucknell,2018,1,147,311,11,0.09090909090909091,-164
Bucknell,2019,3,179,357,11,0.2727272727272727,-178
Bucknell,2020,2,71,77,4,0.5,-6
Bucknell,2021,1,104,417,11,0.09090909090909091,-313
Bucknell,2022,3,141,312,11,0.2727272727272727,-171
Bucknell,2023,4,288,371,11,0.36363636363636365,-83
Buena Vista,2022,4,227,433,10,0.4,-206
Buena Vista,2023,2,143,415,10,0.2,-272
Buffalo,2015,5,320,331,12,0.4166666666666667,-11
Buffalo,2016,2,198,388,12,0.16666666666666666,-190
Buffalo,2017,6,342,298,12,0.5,44
Buffalo,2018,10,484,363,14,0.7142857142857143,121
Buffalo,2019,8,409,277,13,0.6153846153846154,132
Buffalo,2020,6,304,153,7,0.8571428571428571,151
Buffalo,2021,4,351,359,12,0.3333333333333333,-8
Buffalo,2022,7,371,347,13,0.5384615384615384,24
Buffalo,2023,3,251,329,12,0.25,-78
Buffalo State,2022,0,84,457,10,0.0,-373
Buffalo State,2023,2,209,358,10,0.2,-149
Butler,2015,5,269,255,10,0.5,14
Butler,2016,4,270,318,11,0.36363636363636365,-48
Butler,2017,6,294,275,11,0.5454545454545454,19
Butler,2018,4,259,372,11,0.36363636363636365,-113
Butler,2019,3,238,428,12,0.25,-190
Butler,2020,0,91,175,6,0.0,-84
Butler,2021,3,262,377,11,0.2727272727272727,-115
Butler,2022,7,300,244,11,0.6363636363636364,56
Butler,2023,7,318,193,11,0.6363636363636364,125
CSU Pueblo,2021,6,297,197,11,0.5454545454545454,100
CSU Pueblo,2022,8,432,263,12,0.6666666666666666,169
CSU Pueblo,2023,8,462,262,11,0.7272727272727273,200
Cal Poly,2015,4,372,390,11,0.36363636363636365,-18
Cal Poly,2016,7,416,394,12,0.5833333333333334,22
Cal Poly,2017,1,203,352,11,0.09090909090909091,-149
Cal Poly,2018,5,315,400,11,0.45454545454545453,-85
Cal Poly,2019,3,277,375,11,0.2727272727272727,-98
Cal Poly,2020,0,58,169,3,0.0,-111
Cal Poly,2021,2,169,431,11,0.18181818181818182,-262
Cal Poly,2022,2,241,467,11,0.18181818181818182,-226
Cal Poly,2023,3,226,434,11,0.2727272727272727,-208
California,2015,8,493,399,13,0.6153846153846154,94
California,2016,5,445,511,12,0.4166666666666667,-66
California,2017,5,333,341,12,0.4166666666666667,-8
California,2018,7,280,258,13,0.5384615384615384,22
California,2019,8,276,285,13,0.6153846153846154,-9
California,2020,1,81,106,4,0.25,-25
California,2021,5,285,267,12,0.4166666666666667,18
California,2022,4,287,334,12,0.3333333333333333,-47
California,2023,6,393,426,13,0.46153846153846156,-33
California Lutheran University,2022,4,264,288,10,0.4,-24
California Lutheran University,2023,3,256,299,10,0.3,-43
Campbell,2015,5,270,195,11,0.45454545454545453,75
Campbell,2016,5,281,244,10,0.5,37
Campbell,2017,6,372,247,11,0.5454545454545454,125
Campbell,2018,6,273,242,11,0.5454545454545454,31
Campbell,2019,6,325,341,11,0.5454545454545454,-16
Campbell,2020,0,82,188,4,0.0,-106
Campbell,2021,3,282,321,11,0.2727272727272727,-39
Campbell,2022,5,341,311,11,0.45454545454545453,30
Campbell,2023,5,316,366,11,0.45454545454545453,-50
Capital,2020,0,50,186,4,0.0,-136
Capital,2022,0,185,415,10,0.0,-230
Capital,2023,1,222,484,10,0.1,-262
Carleton,2022,6,346,186,9,0.6666666666666666,160
Carleton,2023,7,293,316,10,0.7,-23
Carnegie Mellon,2020,2,107,63,4,0.5,44
Carnegie Mellon,2022,10,302,151,12,0.8333333333333334,151
Carnegie Mellon,2023,9,351,105,10,0.9,246
Carroll University (WI),2022,6,293,305,10,0.6,-12
Carroll University (WI),2023,5,364,280,10,0.5,84
Carson-Newman College,2020,1,40,37,1,1.0,3
Carson-Newman College,2021,1,127,378,10,0.1,-251
Carson-Newman College,2022,6,284,262,11,0.5454545454545454,22
Carson-Newman College,2023,5,245,231,11,0.45454545454545453,14
Carthage,2020,2,62,19,2,1.0,43
Carthage,2022,3,194,411,10,0.3,-217
Carthage,2023,3,161,346,10,0.3,-185
Case Western Reserve,2022,6,284,185,10,0.6,99
Case Western Reserve,2023,7,295,135,10,0.7,160
Castleton,2022,5,272,193,10,0.5,79
Castleton,2023,2,157,256,9,0.2222222222222222,-99
Catawba,2015,1,35,21,1,1.0,14
Catawba,2017,1,27,20,1,1.0,7
Catawba,2020,0,27,61,2,0.0,-34
Catawba,2021,5,177,229,9,0.5555555555555556,-52
Catawba,2022,1,216,450,11,0.09090909090909091,-234
Catawba,2023,5,280,286,11,0.45454545454545453,-6
Catholic,2019,0,0,69,1,0.0,-69
Catholic,2022,6,248,266,10,0.6,-18
Catholic,2023,5,259,278,10,0.5,-19
Central Arkansas,2015,6,268,263,10,0.6,5
Central Arkansas,2016,10,430,282,13,0.7692307692307693,148
Central Arkansas,2017,10,429,210,12,0.8333333333333334,219
Central Arkansas,2018,6,336,287,11,0.5454545454545454,49
Central Arkansas,2019,9,361,346,13,0.6923076923076923,15
Central Arkansas,2020,5,291,261,9,0.5555555555555556,30
Central Arkansas,2021,5,379,316,11,0.45454545454545453,63
Central Arkansas,2022,5,353,351,11,0.45454545454545453,2
Central Arkansas,2023,7,337,246,11,0.6363636363636364,91
Central College,2020,2,86,33,2,1.0,53
Central College,2022,7,413,214,10,0.7,199
Central College,2023,8,428,162,10,0.8,266
Central Connecticut,2015,4,190,283,11,0.36363636363636365,-93
Central Connecticut,2016,2,245,383,11,0.18181818181818182,-138
Central Connecticut,2017,8,352,313,12,0.6666666666666666,39
Central Connecticut,2018,6,372,280,11,0.5454545454545454,92
Central Connecticut,2019,11,440,262,13,0.8461538461538461,178
Central Connecticut,2021,4,232,339,11,0.36363636363636365,-107
Central Connecticut,2022,2,191,323,11,0.18181818181818182,-132
Central Connecticut,2023,3,277,343,11,0.2727272727272727,-66
Central Michigan,2015,7,336,286,13,0.5384615384615384,50
Central Michigan,2016,6,342,394,13,0.46153846153846156,-52
Central Michigan,2017,8,370,358,13,0.6153846153846154,12
Central Michigan,2018,1,180,328,12,0.08333333333333333,-148
Central Michigan,2019,8,426,396,14,0.5714285714285714,30
Central Michigan,2020,3,188,181,6,0.5,7
Central Michigan,2021,9,420,335,13,0.6923076923076923,85
Central Michigan,2022,4,297,338,12,0.3333333333333333,-41
Central Michigan,2023,5,278,373,12,0.4166666666666667,-95
Central Missouri,2021,4,327,364,11,0.36363636363636365,-37
Central Missouri,2022,4,262,288,11,0.36363636363636365,-26
Central Missouri,2023,11,642,349,13,0.8461538461538461,293
Central Oklahoma,2021,4,285,276,11,0.36363636363636365,9
Central Oklahoma,2022,6,247,239,11,0.5454545454545454,8
Central Oklahoma,2023,5,297,294,11,0.45454545454545453,3
Central State (OH),2016,0,19,31,1,0.0,-12
Central State (OH),2017,1,40,35,1,1.0,5
Central State (OH),2018,0,45,49,1,0.0,-4
Central State (OH),2019,0,20,63,1,0.0,-43
Central State (OH),2021,1,110,379,10,0.1,-269
Central State (OH),2022,3,260,338,10,0.3,-78
Central State (OH),2023,5,210,287,10,0.5,-77
Central Washington,2018,0,13,58,1,0.0,-45
Central Washington,2019,0,31,41,1,0.0,-10
Central Washington,2020,0,3,59,1,0.0,-56
Central Washington,2021,8,490,249,11,0.7272727272727273,241
Central Washington,2022,6,260,189,10,0.6,71
Central Washington,2023,9,302,303,13,0.6923076923076923,-1
Centre College Kentucky,2020,2,126,80,4,0.5,46
Centre College Kentucky,2022,6,281,238,10,0.6,43
Centre College Kentucky,2023,6,292,248,10,0.6,44
Chadron St,2015,0,13,21,1,0.0,-8
Chadron St,2021,6,359,242,11,0.5454545454545454,117
Chadron St,2022,3,228,357,11,0.2727272727272727,-129
Chadron St,2023,5,267,326,11,0.45454545454545453,-59
Chapman,2022,7,386,247,10,0.7,139
Chapman,2023,6,258,182,11,0.5454545454545454,76
Charleston Southern,2015,10,368,282,13,0.7692307692307693,86
Charleston Southern,2016,7,363,244,11,0.6363636363636364,119
Charleston Southern,2017,6,250,218,11,0.5454545454545454,32
Charleston Southern,2018,5,233,259,11,0.45454545454545453,-26
Charleston Southern,2019,6,267,371,12,0.5,-104
Charleston Southern,2020,2,83,80,4,0.5,3
Charleston Southern,2021,4,245,289,10,0.4,-44
Charleston Southern,2022,2,207,327,10,0.2,-120
Charleston Southern,2023,4,176,321,11,0.36363636363636365,-145
Charlotte,2015,2,210,435,12,0.16666666666666666,-225
Charlotte,2016,4,302,415,12,0.3333333333333333,-113
Charlotte,2017,1,170,393,12,0.08333333333333333,-223
Charlotte,2018,5,260,319,12,0.4166666666666667,-59
Charlotte,2019,7,388,421,13,0.5384615384615384,-33
Charlotte,2020,2,162,195,6,0.3333333333333333,-33
Charlotte,2021,5,326,408,12,0.4166666666666667,-82
Charlotte,2022,3,293,473,12,0.25,-180
Charlotte,2023,3,210,343,12,0.25,-133
Chattanooga,2015,9,384,291,13,0.6923076923076923,93
Chattanooga,2016,9,445,255,13,0.6923076923076923,190
Chattanooga,2017,3,195,284,11,0.2727272727272727,-89
Chattanooga,2018,6,236,231,11,0.5454545454545454,5
Chattanooga,2019,6,315,360,12,0.5,-45
Chattanooga,2020,3,107,103,5,0.6,4
Chattanooga,2021,6,293,188,11,0.5454545454545454,105
Chattanooga,2022,7,320,227,11,0.6363636363636364,93
Chattanooga,2023,8,357,319,13,0.6153846153846154,38
Chicago,2022,7,366,101,9,0.7777777777777778,265
Chicago,2023,6,325,204,10,0.6,121
Chowan,2015,1,34,65,2,0.5,-31
Chowan,2016,0,14,47,1,0.0,-33
Chowan,2018,0,54,98,2,0.0,-44
Chowan,2021,7,385,226,10,0.7,159
Chowan,2022,6,193,179,9,0.6666666666666666,14
Chowan,2023,0,150,392,10,0.0,-242
Christopher Newport,2020,0,12,53,2,0.0,-41
Christopher Newport,2022,7,213,138,9,0.7777777777777778,75
Christopher Newport,2023,7,305,187,11,0.6363636363636364,118
Cincinnati,2015,7,440,405,13,0.5384615384615384,35
Cincinnati,2016,4,232,323,12,0.3333333333333333,-91
Cincinnati,2017,4,251,382,12,0.3333333333333333,-131
Cincinnati,2018,11,454,224,13,0.8461538461538461,230
Cincinnati,2019,11,415,288,14,0.7857142857142857,127
Cincinnati,2020,9,375,168,10,0.9,207
Cincinnati,2021,13,516,236,14,0.9285714285714286,280
Cincinnati,2022,9,380,268,13,0.6923076923076923,112
Cincinnati,2023,3,289,360,12,0.25,-71
Claremont-Mudd-Scripps College,2022,7,283,83,9,0.7777777777777778,200
Claremont-Mudd-Scripps College,2023,8,248,157,10,0.8,91
Clarion,2017,0,0,36,1,0.0,-36
Clarion,2021,0,148,462,10,0.0,-314
Clarion,2022,3,206,369,11,0.2727272727272727,-163
Clarion,2023,2,218,321,11,0.18181818181818182,-103
Clark Atlanta,2015,0,0,43,1,0.0,-43
Clark Atlanta,2016,0,0,56,1,0.0,-56
Clark Atlanta,2017,0,20,31,1,0.0,-11
Clark Atlanta,2018,0,13,70,1,0.0,-57
Clark Atlanta,2021,2,145,313,10,0.2,-168
Clark Atlanta,2022,3,228,338,10,0.3,-110
Clark Atlanta,2023,0,181,342,10,0.0,-161
Clemson,2015,14,577,325,15,0.9333333333333333,252
Clemson,2016,14,588,270,15,0.9333333333333333,318
Clemson,2017,12,466,190,14,0.8571428571428571,276
Clemson,2018,15,664,197,15,1.0,467
Clemson,2019,14,659,203,15,0.9333333333333333,456
Clemson,2020,10,522,242,12,0.8333333333333334,280
Clemson,2021,10,342,193,13,0.7692307692307693,149
Clemson,2022,11,465,292,14,0.7857142857142857,173
Clemson,2023,9,388,274,13,0.6923076923076923,114
Coast Guard,2022,3,265,297,10,0.3,-32
Coast Guard,2023,5,355,326,10,0.5,29
Coastal Carolina,2015,9,421,241,12,0.75,180
Coastal Carolina,2016,10,447,232,12,0.8333333333333334,215
Coastal Carolina,2017,3,284,408,12,0.25,-124
Coastal Carolina,2018,5,320,398,12,0.4166666666666667,-78
Coastal Carolina,2019,5,364,366,12,0.4166666666666667,-2
Coastal Carolina,2020,11,446,243,12,0.9166666666666666,203
Coastal Carolina,2021,11,532,281,13,0.8461538461538461,251
Coastal Carolina,2022,9,378,414,13,0.6923076923076923,-36
Coastal Carolina,2023,8,360,310,13,0.6153846153846154,50
Coe College,2020,0,13,17,1,0.0,-4
Coe College,2022,7,324,159,10,0.7,165
Coe College,2023,9,424,127,11,0.8181818181818182,297
Colby College,2022,4,156,181,9,0.4444444444444444,-25
Colby College,2023,3,146,251,9,0.3333333333333333,-105
Colgate,2015,9,356,401,14,0.6428571428571429,-45
Colgate,2016,5,311,234,10,0.5,77
Colgate,2017,7,305,192,11,0.6363636363636364,113
Colgate,2018,10,324,112,12,0.8333333333333334,212
Colgate,2019,4,178,324,12,0.3333333333333333,-146
Colgate,2020,0,18,64,2,0.0,-46
Colgate,2021,5,206,287,11,0.45454545454545453,-81
Colgate,2022,3,237,335,11,0.2727272727272727,-98
Colgate,2023,6,251,359,11,0.5454545454545454,-108
College Of New Jersey,2022,3,165,255,9,0.3333333333333333,-90
College Of New Jersey,2023,5,219,225,11,0.45454545454545453,-6
College of Idaho,2017,0,14,41,1,0.0,-27
College of Idaho,2018,0,14,63,1,0.0,-49
Colorado,2015,4,320,357,13,0.3076923076923077,-37
Colorado,2016,10,435,304,14,0.7142857142857143,131
Colorado,2017,5,317,338,12,0.4166666666666667,-21
Colorado,2018,5,325,327,12,0.4166666666666667,-2
Colorado,2019,5,282,382,12,0.4166666666666667,-100
Colorado,2020,4,171,190,6,0.6666666666666666,-19
Colorado,2021,4,225,320,12,0.3333333333333333,-95
Colorado,2022,1,185,534,12,0.08333333333333333,-349
Colorado,2023,4,338,418,12,0.3333333333333333,-80
Colorado Mesa,2021,8,337,156,10,0.8,181
Colorado Mesa,2022,4,360,327,10,0.4,33
Colorado Mesa,2023,6,306,327,11,0.5454545454545454,-21
Colorado School Of Mines,2021,12,541,206,14,0.8571428571428571,335
Colorado School Of Mines,2022,13,714,308,16,0.8125,406
Colorado School Of Mines,2023,14,698,195,15,0.9333333333333333,503
Colorado State,2015,7,385,354,13,0.5384615384615384,31
Colorado State,2016,7,459,395,13,0.5384615384615384,64
Colorado State,2017,7,434,361,13,0.5384615384615384,73
Colorado State,2018,3,274,441,12,0.25,-167
Colorado State,2019,4,337,374,12,0.3333333333333333,-37
Colorado State,2020,1,89,143,4,0.25,-54
Colorado State,2021,3,284,339,12,0.25,-55
Colorado State,2022,3,158,323,12,0.25,-165
Colorado State,2023,5,313,355,12,0.4166666666666667,-42
Columbia,2015,2,143,198,10,0.2,-55
Columbia,2016,3,185,247,10,0.3,-62
Columbia,2017,8,239,175,10,0.8,64
Columbia,2018,6,231,252,10,0.6,-21
Columbia,2019,3,193,286,10,0.3,-93
Columbia,2021,7,251,225,10,0.7,26
Columbia,2022,6,265,208,10,0.6,57
Columbia,2023,3,149,182,10,0.3,-33
Columbus State,2023,0,0,49,1,0.0,-49
Concord University,2020,1,52,14,1,1.0,38
Concord University,2021,4,208,263,10,0.4,-55
Concord University,2022,9,435,335,11,0.8181818181818182,100
Concord University,2023,1,191,445,11,0.09090909090909091,-254
Concordia Moorhead,2022,4,233,174,8,0.5,59
Concordia Moorhead,2023,5,333,257,10,0.5,76
Concordia University Chicago,2020,0,16,103,3,0.0,-87
Concordia University Chicago,2022,3,187,325,10,0.3,-138
Concordia University Chicago,2023,1,211,463,10,0.1,-252
Concordia University St Paul,2021,1,162,402,11,0.09090909090909091,-240
Concordia University St Paul,2022,1,158,360,11,0.09090909090909091,-202
Concordia University St Paul,2023,3,228,357,11,0.2727272727272727,-129
Concordia-Michigan,2016,0,0,38,1,0.0,-38
Concordia-Michigan,2022,0,14,24,1,0.0,-10
Concordia-Michigan,2023,1,24,23,1,1.0,1
Concordia-Wisconsin,2020,3,133,121,5,0.6,12
Concordia-Wisconsin,2022,8,276,228,10,0.8,48
Concordia-Wisconsin,2023,7,330,188,10,0.7,142
Cornell,2015,1,142,297,10,0.1,-155
Cornell,2016,4,230,310,10,0.4,-80
Cornell,2017,3,173,243,10,0.3,-70
Cornell,2018,3,191,297,10,0.3,-106
Cornell,2019,4,206,207,10,0.4,-1
Cornell,2021,2,201,289,10,0.2,-88
Cornell,2022,5,216,283,10,0.5,-67
Cornell,2023,3,182,241,10,0.3,-59
Cornell College (IA),2022,3,198,333,10,0.3,-135
Cornell College (IA),2023,6,282,355,10,0.6,-73
Cortland,2022,9,496,192,11,0.8181818181818182,304
Cortland,2023,14,693,296,15,0.9333333333333333,397
Crown College,2022,4,193,395,10,0.4,-202
Crown College,2023,1,194,362,9,0.1111111111111111,-168
Cumberland (TN),2016,0,16,23,1,0.0,-7
Cumberland (TN),2017,0,20,27,1,0.0,-7
Cumberland (TN),2018,0,0,55,1,0.0,-55
Curry College,2022,3,245,313,10,0.3,-68
Curry College,2023,3,189,326,10,0.3,-137
Dakota State University,2022,0,7,42,1,0.0,-35
Dakota State University,2023,0,6,31,1,0.0,-25
Dartmouth,2015,9,288,101,10,0.9,187
Dartmouth,2016,4,201,213,10,0.4,-12
Dartmouth,2017,8,274,200,10,0.8,74
Dartmouth,2018,9,340,120,10,0.9,220
Dartmouth,2019,9,333,124,10,0.9,209
Dartmouth,2021,9,306,147,10,0.9,159
Dartmouth,2022,3,201,205,10,0.3,-4
Dartmouth,2023,6,232,193,10,0.6,39
Davenport,2020,2,67,44,2,1.0,23
Davenport,2021,2,94,279,10,0.2,-185
Davenport,2022,8,336,322,11,0.7272727272727273,14
Davenport,2023,8,276,199,10,0.8,77
Davidson,2015,2,138,389,11,0.18181818181818182,-251
Davidson,2016,2,191,323,11,0.18181818181818182,-132
Davidson,2017,2,220,376,11,0.18181818181818182,-156
Davidson,2018,6,494,449,11,0.5454545454545454,45
Davidson,2019,8,420,248,12,0.6666666666666666,172
Davidson,2020,4,183,194,7,0.5714285714285714,-11
Davidson,2021,8,400,322,11,0.7272727272727273,78
Davidson,2022,8,383,292,12,0.6666666666666666,91
Davidson,2023,7,433,310,11,0.6363636363636364,123
Dayton,2015,10,296,229,12,0.8333333333333334,67
Dayton,2016,9,356,218,11,0.8181818181818182,138
Dayton,2017,5,238,217,11,0.45454545454545453,21
Dayton,2018,6,394,287,11,0.5454545454545454,107
Dayton,2019,8,468,382,11,0.7272727272727273,86
Dayton,2021,6,311,301,10,0.6,10
Dayton,2022,8,313,247,11,0.7272727272727273,66
Dayton,2023,4,264,267,11,0.36363636363636365,-3
Dean College,2022,1,258,383,10,0.1,-125
Dean College,2023,2,136,476,10,0.2,-340
Defiance College,2020,2,142,238,7,0.2857142857142857,-96
Defiance College,2022,3,238,422,10,0.3,-184
Defiance College,2023,4,320,375,10,0.4,-55
Delaware,2015,4,164,225,11,0.36363636363636365,-61
Delaware,2016,4,242,276,11,0.36363636363636365,-34
Delaware,2017,7,233,185,11,0.6363636363636364,48
Delaware,2018,7,293,258,12,0.5833333333333334,35
Delaware,2019,5,278,344,12,0.4166666666666667,-66
Delaware,2020,7,206,115,8,0.875,91
Delaware,2021,5,217,257,11,0.45454545454545453,-40
Delaware,2022,8,366,237,13,0.6153846153846154,129
Delaware,2023,9,411,312,13,0.6923076923076923,99
Delaware State,2015,1,158,380,11,0.09090909090909091,-222
Delaware State,2016,0,162,437,11,0.0,-275
Delaware State,2017,2,158,420,11,0.18181818181818182,-262
Delaware State,2018,3,184,369,11,0.2727272727272727,-185
Delaware State,2019,2,235,369,12,0.16666666666666666,-134
Delaware State,2020,2,105,120,5,0.4,-15
Delaware State,2021,5,258,278,11,0.45454545454545453,-20
Delaware State,2022,5,212,254,11,0.45454545454545453,-42
Delaware State,2023,1,198,412,11,0.09090909090909091,-214
Delaware Valley,2022,12,391,119,13,0.9230769230769231,272
Delaware Valley,2023,9,268,137,11,0.8181818181818182,131
Delta State,2021,5,283,326,11,0.45454545454545453,-43
Delta State,2022,11,535,300,13,0.8461538461538461,235
Delta State,2023,10,515,226,12,0.8333333333333334,289
Denison University,2020,1,38,37,1,1.0,1
Denison University,2022,8,373,215,10,0.8,158
Denison University,2023,7,344,227,10,0.7,117
Depauw,2020,2,76,28,2,1.0,48
Depauw,2021,0,24,49,1,0.0,-25
Depauw,2022,9,414,172,11,0.8181818181818182,242
Depauw,2023,10,463,171,11,0.9090909090909091,292
Dickinson (PA),2022,3,191,238,10,0.3,-47
Dickinson (PA),2023,6,248,251,10,0.6,-3
Dickinson State University,2022,0,2,17,1,0.0,-15
Dickinson State University,2023,1,24,21,1,1.0,3
Drake,2015,5,254,263,11,0.45454545454545453,-9
Drake,2016,7,310,311,11,0.6363636363636364,-1
Drake,2017,7,295,279,11,0.6363636363636364,16
Drake,2018,7,326,210,11,0.6363636363636364,116
Drake,2019,6,273,279,11,0.5454545454545454,-6
Drake,2020,2,91,64,5,0.4,27
Drake,2021,2,127,228,11,0.18181818181818182,-101
Drake,2022,3,194,309,11,0.2727272727272727,-115
Drake,2023,8,226,315,12,0.6666666666666666,-89
Dubuque,2020,1,17,13,1,1.0,4
Dubuque,2022,6,307,198,10,0.6,109
Dubuque,2023,5,311,254,10,0.5,57
Duke,2015,8,410,330,13,0.6153846153846154,80
Duke,2016,4,280,338,12,0.3333333333333333,-58
Duke,2017,7,345,263,13,0.5384615384615384,82
Duke,2018,8,382,356,13,0.6153846153846154,26
Duke,2019,5,303,350,12,0.4166666666666667,-47
Duke,2020,2,273,419,11,0.18181818181818182,-146
Duke,2021,3,274,477,12,0.25,-203
Duke,2022,9,427,287,13,0.6923076923076923,140
Duke,2023,8,350,247,13,0.6153846153846154,103
Duquesne,2015,8,368,231,12,0.6666666666666666,137
Duquesne,2016,8,343,273,11,0.7272727272727273,70
Duquesne,2017,7,354,262,11,0.6363636363636364,92
Duquesne,2018,9,380,363,13,0.6923076923076923,17
Duquesne,2019,6,245,260,11,0.5454545454545454,-15
Duquesne,2020,4,102,54,4,1.0,48
Duquesne,2021,7,295,229,10,0.7,66
Duquesne,2022,4,270,303,11,0.36363636363636365,-33
Duquesne,2023,7,325,361,12,0.5833333333333334,-36
ERSKINE,2020,1,105,219,6,0.16666666666666666,-114
ERSKINE,2021,3,248,400,11,0.2727272727272727,-152
ERSKINE,2022,2,175,356,11,0.18181818181818182,-181
ERSKINE,2023,0,119,425,11,0.0,-306
East Carolina,2015,5,329,312,12,0.4166666666666667,17
East Carolina,2016,3,324,433,12,0.25,-109
East Carolina,2017,3,299,540,12,0.25,-241
East Carolina,2018,3,273,448,12,0.25,-175
East Carolina,2019,4,321,404,12,0.3333333333333333,-83
East Carolina,2020,3,272,319,9,0.3333333333333333,-47
East Carolina,2021,7,356,315,12,0.5833333333333334,41
East Carolina,2022,8,423,353,13,0.6153846153846154,70
East Carolina,2023,2,208,269,12,0.16666666666666666,-61
East Central (OK),2020,1,21,14,1,1.0,7
East Central (OK),2021,7,292,306,11,0.6363636363636364,-14
East Central (OK),2022,8,306,206,11,0.7272727272727273,100
East Central (OK),2023,3,210,284,11,0.2727272727272727,-74
East Stroudsburg University,2019,1,24,14,1,1.0,10
East Stroudsburg University,2021,5,244,240,11,0.45454545454545453,4
East Stroudsburg University,2022,4,247,256,11,0.36363636363636365,-9
East Stroudsburg University,2023,9,388,280,12,0.75,108
East Tennessee State,2015,2,180,416,11,0.18181818181818182,-236
East Tennessee State,2016,5,174,308,11,0.45454545454545453,-134
East Tennessee State,2017,4,211,313,11,0.36363636363636365,-102
East Tennessee State,2018,8,312,317,12,0.6666666666666666,-5
East Tennessee State,2019,3,241,314,12,0.25,-73
East Tennessee State,2020,4,126,113,6,0.6666666666666666,13
East Tennessee State,2021,11,425,295,13,0.8461538461538461,130
East Tennessee State,2022,3,323,336,11,0.2727272727272727,-13
East Tennessee State,2023,3,200,350,11,0.2727272727272727,-150
East Texas A&M,2015,0,24,38,1,0.0,-14
East Texas A&M,2017,1,37,27,1,1.0,10
East Texas A&M,2021,7,330,151,11,0.6363636363636364,179
East Texas A&M,2022,5,304,219,11,0.45454545454545453,85
East Texas A&M,2023,2,160,323,11,0.18181818181818182,-163
East Texas Baptist University,2020,3,168,106,5,0.6,62
East Texas Baptist University,2022,5,211,228,10,0.5,-17
East Texas Baptist University,2023,5,201,258,10,0.5,-57
Eastern Illinois,2015,7,283,319,12,0.5833333333333334,-36
Eastern Illinois,2016,6,294,310,11,0.5454545454545454,-16
Eastern Illinois,2017,6,194,286,11,0.5454545454545454,-92
Eastern Illinois,2018,3,357,445,11,0.2727272727272727,-88
Eastern Illinois,2019,1,177,364,12,0.08333333333333333,-187
Eastern Illinois,2020,1,120,201,6,0.16666666666666666,-81
Eastern Illinois,2021,1,160,312,11,0.09090909090909091,-152
Eastern Illinois,2022,2,245,343,11,0.18181818181818182,-98
Eastern Illinois,2023,8,260,217,11,0.7272727272727273,43
Eastern Kentucky,2015,6,333,271,11,0.5454545454545454,62
Eastern Kentucky,2016,3,287,336,11,0.2727272727272727,-49
Eastern Kentucky,2017,4,228,292,11,0.36363636363636365,-64
Eastern Kentucky,2018,7,296,316,11,0.6363636363636364,-20
Eastern Kentucky,2019,7,335,264,12,0.5833333333333334,71
Eastern Kentucky,2020,3,217,299,9,0.3333333333333333,-82
Eastern Kentucky,2021,7,304,275,11,0.6363636363636364,29
Eastern Kentucky,2022,7,434,422,12,0.5833333333333334,12
Eastern Kentucky,2023,5,324,365,11,0.45454545454545453,-41
Eastern Michigan,2015,1,305,505,12,0.08333333333333333,-200
Eastern Michigan,2016,7,385,388,13,0.5384615384615384,-3
Eastern Michigan,2017,5,313,280,12,0.4166666666666667,33
Eastern Michigan,2018,7,351,287,13,0.5384615384615384,64
Eastern Michigan,2019,6,379,398,13,0.46153846153846156,-19
Eastern Michigan,2020,2,199,216,6,0.3333333333333333,-17
Eastern Michigan,2021,7,392,390,13,0.5384615384615384,2
Eastern Michigan,2022,9,387,370,13,0.6923076923076923,17
Eastern Michigan,2023,6,254,347,13,0.46153846153846156,-93
Eastern New Mexico,2021,3,264,377,10,0.3,-113
Eastern New Mexico,2022,3,208,346,11,0.2727272727272727,-138
Eastern New Mexico,2023,5,353,318,11,0.45454545454545453,35
Eastern Oregon,2015,0,20,41,1,0.0,-21
Eastern Oregon,2019,0,9,59,1,0.0,-50
Eastern Oregon,2022,0,7,33,1,0.0,-26
Eastern Oregon,2023,0,28,42,1,0.0,-14
Eastern University,2023,2,163,292,10,0.2,-129
Eastern Washington,2015,6,381,435,11,0.5454545454545454,-54
Eastern Washington,2016,12,593,371,14,0.8571428571428571,222
Eastern Washington,2017,7,379,367,11,0.6363636363636364,12
Eastern Washington,2018,12,647,340,15,0.8,307
Eastern Washington,2019,7,487,415,12,0.5833333333333334,72
Eastern Washington,2020,5,264,188,7,0.7142857142857143,76
Eastern Washington,2021,10,572,362,13,0.7692307692307693,210
Eastern Washington,2022,3,271,466,11,0.2727272727272727,-195
Eastern Washington,2023,4,355,397,11,0.36363636363636365,-42
Edinboro University,2021,4,206,243,10,0.4,-37
Edinboro University,2022,5,188,309,11,0.45454545454545453,-121
Edinboro University,2023,3,232,353,11,0.2727272727272727,-121
Edward Waters,2015,0,35,107,2,0.0,-72
Edward Waters,2016,0,7,41,1,0.0,-34
Edward Waters,2017,0,3,37,1,0.0,-34
Edward Waters,2018,0,12,52,1,0.0,-40
Edward Waters,2019,0,14,102,2,0.0,-88
Edward Waters,2020,1,26,125,3,0.3333333333333333,-99
Edward Waters,2021,3,233,324,10,0.3,-91
Edward Waters,2022,5,344,296,11,0.45454545454545453,48
Edward Waters,2023,6,293,315,10,0.6,-22
Elizabeth City State,2016,0,33,103,2,0.0,-70
Elizabeth City State,2019,0,14,110,2,0.0,-96
Elizabeth City State,2021,3,170,375,10,0.3,-205
Elizabeth City State,2022,2,126,310,9,0.2222222222222222,-184
Elizabeth City State,2023,3,183,220,10,0.3,-37
Elmhurst,2022,0,114,423,10,0.0,-309
Elmhurst,2023,2,116,459,10,0.2,-343
Elon,2015,4,147,273,11,0.36363636363636365,-126
Elon,2016,2,134,338,11,0.18181818181818182,-204
Elon,2017,8,256,298,12,0.6666666666666666,-42
Elon,2018,6,268,260,11,0.5454545454545454,8
Elon,2019,5,276,297,11,0.45454545454545453,-21
Elon,2020,1,104,185,6,0.16666666666666666,-81
Elon,2021,6,265,287,11,0.5454545454545454,-22
Elon,2022,8,309,256,12,0.6666666666666666,53
Elon,2023,6,272,264,11,0.5454545454545454,8
Emory & Henry College,2015,1,27,24,1,1.0,3
Emory & Henry College,2020,3,121,33,4,0.75,88
Emory & Henry College,2022,5,262,283,11,0.45454545454545453,-21
Emory & Henry College,2023,5,313,280,11,0.45454545454545453,33
Emporia State University,2021,6,344,302,11,0.5454545454545454,42
Emporia State University,2022,8,356,233,11,0.7272727272727273,123
Emporia State University,2023,8,433,304,11,0.7272727272727273,129
Endicott College,2022,10,350,82,11,0.9090909090909091,268
Endicott College,2023,9,379,107,11,0.8181818181818182,272
Eureka College,2020,2,130,149,5,0.4,-19
Eureka College,2022,2,180,362,10,0.2,-182
Eureka College,2023,4,247,326,10,0.4,-79
FDU-Florham,2022,6,195,174,10,0.6,21
FDU-Florham,2023,5,198,188,10,0.5,10
Fairmont State,2021,5,246,318,11,0.45454545454545453,-72
Fairmont State,2022,3,276,290,11,0.2727272727272727,-14
Fairmont State,2023,7,308,294,11,0.6363636363636364,14
Faulkner University,2022,0,0,70,1,0.0,-70
Fayetteville State,2016,0,3,26,1,0.0,-23
Fayetteville State,2021,8,303,125,10,0.8,178
Fayetteville State,2022,8,239,179,11,0.7272727272727273,60
Fayetteville State,2023,8,196,175,11,0.7272727272727273,21
Ferris State,2018,0,47,49,1,0.0,-2
Ferris State,2021,14,661,256,14,1.0,405
Ferris State,2022,14,530,219,15,0.9333333333333333,311
Ferris State,2023,8,442,197,11,0.7272727272727273,245
Ferrum,2020,2,111,132,5,0.4,-21
Ferrum,2022,1,162,333,10,0.1,-171
Ferrum,2023,3,166,303,10,0.3,-137
Findlay,2020,4,203,81,6,0.6666666666666666,122
Findlay,2021,8,370,304,12,0.6666666666666666,66
Findlay,2022,7,311,253,11,0.6363636363636364,58
Findlay,2023,7,310,199,11,0.6363636363636364,111
Finlandia University,2022,0,72,418,10,0.0,-346
Fitchburg State,2022,1,84,481,10,0.1,-397
Fitchburg State,2023,0,85,382,10,0.0,-297
Florida,2015,10,325,256,14,0.7142857142857143,69
Florida,2016,9,311,218,13,0.6923076923076923,93
Florida,2017,4,243,300,11,0.36363636363636365,-57
Florida,2018,10,455,260,13,0.7692307692307693,195
Florida,2019,11,432,201,13,0.8461538461538461,231
Florida,2020,8,478,370,12,0.6666666666666666,108
Florida,2021,6,399,348,13,0.46153846153846156,51
Florida,2022,6,384,375,13,0.46153846153846156,9
Florida,2023,5,341,331,12,0.4166666666666667,10
Florida A&M,2015,1,161,369,11,0.09090909090909091,-208
Florida A&M,2016,4,206,361,11,0.36363636363636365,-155
Florida A&M,2017,3,242,309,11,0.2727272727272727,-67
Florida A&M,2018,6,290,243,11,0.5454545454545454,47
Florida A&M,2019,9,360,301,11,0.8181818181818182,59
Florida A&M,2021,9,333,204,12,0.75,129
Florida A&M,2022,9,281,246,11,0.8181818181818182,35
Florida A&M,2023,12,398,197,13,0.9230769230769231,201
Florida Atlantic,2015,3,270,345,12,0.25,-75
Florida Atlantic,2016,3,317,477,12,0.25,-160
Florida Atlantic,2017,11,568,318,14,0.7857142857142857,250
Florida Atlantic,2018,5,373,380,12,0.4166666666666667,-7
Florida Atlantic,2019,11,510,318,14,0.7857142857142857,192
Florida Atlantic,2020,5,170,157,9,0.5555555555555556,13
Florida Atlantic,2021,5,305,309,12,0.4166666666666667,-4
Florida Atlantic,2022,5,357,319,12,0.4166666666666667,38
Florida Atlantic,2023,4,285,306,12,0.3333333333333333,-21
Florida International,2015,5,306,358,12,0.4166666666666667,-52
Florida International,2016,4,288,418,12,0.3333333333333333,-130
Florida International,2017,8,333,370,13,0.6153846153846154,-37
Florida International,2018,9,450,328,13,0.6923076923076923,122
Florida International,2019,6,344,354,13,0.46153846153846156,-10
Florida International,2020,0,112,162,5,0.0,-50
Florida International,2021,1,244,476,12,0.08333333333333333,-232
Florida International,2022,4,224,447,12,0.3333333333333333,-223
Florida International,2023,4,241,382,12,0.3333333333333333,-141
Florida Memorial University,2022,1,39,120,2,0.5,-81
Florida Memorial University,2023,1,60,79,2,0.5,-19
Florida State,2015,10,412,227,13,0.7692307692307693,185
Florida State,2016,10,456,325,13,0.7692307692307693,131
Florida State,2017,7,362,276,13,0.5384615384615384,86
Florida State,2018,5,263,378,12,0.4166666666666667,-115
Florida State,2019,6,363,362,13,0.46153846153846156,1
Florida State,2020,3,232,324,9,0.3333333333333333,-92
Florida State,2021,5,331,318,12,0.4166666666666667,13
Florida State,2022,10,469,268,13,0.7692307692307693,201
Florida State,2023,13,484,270,14,0.9285714285714286,214
Florida Tech,2015,0,17,28,1,0.0,-11
Florida Tech,2016,1,28,7,1,1.0,21
Fordham,2015,9,442,367,12,0.75,75
Fordham,2016,8,441,331,11,0.7272727272727273,110
Fordham,2017,4,239,384,11,0.36363636363636365,-145
Fordham,2018,2,174,310,11,0.18181818181818182,-136
Fordham,2019,4,300,388,12,0.3333333333333333,-88
Fordham,2020,2,95,59,3,0.6666666666666666,36
Fordham,2021,6,370,351,11,0.5454545454545454,19
Fordham,2022,9,594,434,12,0.75,160
Fordham,2023,6,335,272,11,0.5454545454545454,63
Fort Hays State,2021,5,349,228,11,0.45454545454545453,121
Fort Hays State,2022,3,252,330,11,0.2727272727272727,-78
Fort Hays State,2023,7,366,236,11,0.6363636363636364,130
Fort Lewis,2015,0,14,45,1,0.0,-31
Fort Lewis,2020,0,26,122,2,0.0,-96
Fort Lewis,2021,0,83,590,11,0.0,-507
Fort Lewis,2022,0,82,607,10,0.0,-525
Fort Lewis,2023,0,146,572,11,0.0,-426
Fort Valley State,2017,0,14,31,1,0.0,-17
Fort Valley State,2018,0,7,41,1,0.0,-34
Fort Valley State,2019,0,20,57,1,0.0,-37
Fort Valley State,2020,2,81,39,2,1.0,42
Fort Valley State,2021,5,225,248,10,0.5,-23
Fort Valley State,2022,8,300,227,10,0.8,73
Fort Valley State,2023,7,304,229,10,0.7,75
Framingham State,2022,5,218,185,10,0.5,33
Framingham State,2023,5,190,177,9,0.5555555555555556,13
Franklin,2015,0,14,41,1,0.0,-27
Franklin,2016,0,14,59,1,0.0,-45
Franklin,2017,0,24,43,1,0.0,-19
Franklin,2020,4,216,236,7,0.5714285714285714,-20
Franklin,2022,4,254,305,10,0.4,-51
Franklin,2023,4,295,352,10,0.4,-57
Franklin & Marshall,2022,6,304,193,10,0.6,111
Franklin & Marshall,2023,7,292,204,11,0.6363636363636364,88
Franklin Pierce,2019,0,0,57,1,0.0,-57
Franklin Pierce,2021,0,184,350,10,0.0,-166
Franklin Pierce,2022,2,109,292,10,0.2,-183
Franklin Pierce,2023,4,200,177,10,0.4,23
Fresno State,2015,3,267,457,12,0.25,-190
Fresno State,2016,1,212,371,12,0.08333333333333333,-159
Fresno State,2017,10,380,251,14,0.7142857142857143,129
Fresno State,2018,12,485,198,14,0.8571428571428571,287
Fresno State,2019,4,360,361,12,0.3333333333333333,-1
Fresno State,2020,3,197,180,6,0.5,17
Fresno State,2021,10,434,267,13,0.7692307692307693,167
Fresno State,2022,10,428,272,14,0.7142857142857143,156
Fresno State,2023,9,396,305,13,0.6923076923076923,91
Frostburg State,2020,3,141,73,4,0.75,68
Frostburg State,2021,10,444,180,11,0.9090909090909091,264
Frostburg State,2022,8,303,180,11,0.7272727272727273,123
Frostburg State,2023,7,283,170,11,0.6363636363636364,113
Furman,2015,4,193,318,11,0.36363636363636365,-125
Furman,2016,3,301,298,11,0.2727272727272727,3
Furman,2017,8,424,311,13,0.6153846153846154,113
Furman,2018,6,272,282,10,0.6,-10
Furman,2019,8,435,267,13,0.6153846153846154,168
Furman,2020,3,148,143,7,0.42857142857142855,5
Furman,2021,6,267,259,11,0.5454545454545454,8
Furman,2022,10,430,263,13,0.7692307692307693,167
Furman,2023,10,356,237,13,0.7692307692307693,119
Gallaudet,2022,7,264,301,10,0.7,-37
Gallaudet,2023,4,198,276,9,0.4444444444444444,-78
Gannon,2020,1,72,88,3,0.3333333333333333,-16
Gannon,2021,5,259,320,11,0.45454545454545453,-61
Gannon,2022,8,348,241,11,0.7272727272727273,107
Gannon,2023,5,236,269,11,0.45454545454545453,-33
Gardner-Webb,2015,4,141,227,11,0.36363636363636365,-86
Gardner-Webb,2016,5,276,251,11,0.45454545454545453,25
Gardner-Webb,2017,1,177,311,11,0.09090909090909091,-134
Gardner-Webb,2018,3,221,407,11,0.2727272727272727,-186
Gardner-Webb,2019,3,287,434,12,0.25,-147
Gardner-Webb,2020,2,99,112,4,0.5,-13
Gardner-Webb,2021,4,326,335,11,0.36363636363636365,-9
Gardner-Webb,2022,7,418,377,13,0.5384615384615384,41
Gardner-Webb,2023,7,322,337,12,0.5833333333333334,-15
Geneva,2020,2,79,123,5,0.4,-44
Geneva,2022,3,228,337,10,0.3,-109
Geneva,2023,4,203,308,10,0.4,-105
Georgetown,2015,4,222,296,11,0.36363636363636365,-74
Georgetown,2016,3,166,256,11,0.2727272727272727,-90
Georgetown,2017,1,138,299,11,0.09090909090909091,-161
Georgetown,2018,5,172,232,11,0.45454545454545453,-60
Georgetown,2019,5,266,183,11,0.45454545454545453,83
Georgetown,2021,2,190,306,10,0.2,-116
Georgetown,2022,2,249,401,11,0.18181818181818182,-152
Georgetown,2023,5,283,284,11,0.45454545454545453,-1
Georgia,2015,10,342,220,13,0.7692307692307693,122
Georgia,2016,8,319,312,13,0.6153846153846154,7
Georgia,2017,13,531,246,15,0.8666666666666667,285
Georgia,2018,11,530,269,14,0.7857142857142857,261
Georgia,2019,12,431,176,14,0.8571428571428571,255
Georgia,2020,8,323,200,10,0.8,123
Georgia,2021,14,579,153,15,0.9333333333333333,426
Georgia,2022,15,616,214,15,1.0,402
Georgia,2023,13,562,219,14,0.9285714285714286,343
Georgia Southern,2015,9,474,306,13,0.6923076923076923,168
Georgia Southern,2016,5,319,318,12,0.4166666666666667,1
Georgia Southern,2017,2,250,386,12,0.16666666666666666,-136
Georgia Southern,2018,10,396,280,13,0.7692307692307693,116
Georgia Southern,2019,7,366,366,13,0.5384615384615384,0
Georgia Southern,2020,8,354,270,13,0.6153846153846154,84
Georgia Southern,2021,3,243,377,12,0.25,-134
Georgia Southern,2022,6,425,411,13,0.46153846153846156,14
Georgia Southern,2023,6,392,396,13,0.46153846153846156,-4
Georgia State,2015,6,350,368,13,0.46153846153846156,-18
Georgia State,2016,3,239,319,12,0.25,-80
Georgia State,2017,7,244,297,12,0.5833333333333334,-53
Georgia State,2018,2,286,449,12,0.16666666666666666,-163
Georgia State,2019,7,406,471,13,0.5384615384615384,-65
Georgia State,2020,6,333,317,10,0.6,16
Georgia State,2021,8,366,352,13,0.6153846153846154,14
Georgia State,2022,4,360,374,12,0.3333333333333333,-14
Georgia State,2023,7,354,391,13,0.5384615384615384,-37
Georgia Tech,2015,3,351,309,12,0.25,42
Georgia Tech,2016,9,367,318,13,0.6923076923076923,49
Georgia Tech,2017,5,309,292,11,0.45454545454545453,17
Georgia Tech,2018,7,437,381,13,0.5384615384615384,56
Georgia Tech,2019,3,200,389,12,0.25,-189
Georgia Tech,2020,3,239,368,10,0.3,-129
Georgia Tech,2021,3,288,402,12,0.25,-114
Georgia Tech,2022,5,206,341,12,0.4166666666666667,-135
Georgia Tech,2023,7,404,383,13,0.5384615384615384,21
Gettysburg,2022,1,168,379,10,0.1,-211
Gettysburg,2023,2,229,352,10,0.2,-123
Glenville State,2020,0,48,149,4,0.0,-101
Glenville State,2021,3,210,243,10,0.3,-33
Glenville State,2022,7,331,272,11,0.6363636363636364,59
Glenville State,2023,6,271,243,11,0.5454545454545454,28
Grambling,2015,7,391,312,10,0.7,79
Grambling,2016,12,549,205,13,0.9230769230769231,344
Grambling,2017,11,406,266,13,0.8461538461538461,140
Grambling,2018,6,322,277,11,0.5454545454545454,45
Grambling,2019,6,327,246,11,0.5454545454545454,81
Grambling,2020,0,66,147,4,0.0,-81
Grambling,2021,4,189,304,11,0.36363636363636365,-115
Grambling,2022,3,249,363,11,0.2727272727272727,-114
Grambling,2023,5,316,314,11,0.45454545454545453,2
Grand Valley State University,2021,10,456,223,12,0.8333333333333334,233
Grand Valley State University,2022,12,493,145,13,0.9230769230769231,348
Grand Valley State University,2023,11,569,215,13,0.8461538461538461,354
Greeneville,2018,0,11,20,1,0.0,-9
Greeneville,2020,4,188,88,5,0.8,100
Greeneville,2021,5,366,288,11,0.45454545454545453,78
Greeneville,2022,8,336,197,11,0.7272727272727273,139
Greeneville,2023,6,270,262,11,0.5454545454545454,8
Greensboro College,2020,1,58,121,3,0.3333333333333333,-63
Greensboro College,2022,2,202,418,10,0.2,-216
Greensboro College,2023,2,197,349,10,0.2,-152
Greenville,2020,1,59,123,4,0.25,-64
Greenville,2022,7,363,249,10,0.7,114
Greenville,2023,5,328,225,10,0.5,103
Grinnell,2022,2,75,311,8,0.25,-236
Grinnell,2023,2,138,410,10,0.2,-272
Grove City College,2020,2,95,76,4,0.5,19
Grove City College,2022,7,403,168,10,0.7,235
Grove City College,2023,11,399,183,12,0.9166666666666666,216
Guilford College,2017,0,42,98,2,0.0,-56
Guilford College,2018,0,61,91,1,0.0,-30
Guilford College,2020,0,30,175,4,0.0,-145
Guilford College,2022,1,206,384,10,0.1,-178
Guilford College,2023,2,197,382,10,0.2,-185
Gustavus Adolphus,2022,6,362,185,9,0.6666666666666666,177
Gustavus Adolphus,2023,6,359,257,10,0.6,102
Hamilton,2022,2,139,292,9,0.2222222222222222,-153
Hamilton,2023,3,159,224,9,0.3333333333333333,-65
Hamline University,2022,2,189,350,9,0.2222222222222222,-161
Hamline University,2023,4,252,350,10,0.4,-98
Hampden-Sydney,2020,4,139,61,5,0.8,78
Hampden-Sydney,2022,5,330,305,10,0.5,25
Hampden-Sydney,2023,6,329,267,10,0.6,62
Hampton,2015,6,288,233,11,0.5454545454545454,55
Hampton,2016,5,213,269,11,0.45454545454545453,-56
Hampton,2017,6,236,243,11,0.5454545454545454,-7
Hampton,2018,6,301,266,9,0.6666666666666666,35
Hampton,2019,5,369,373,12,0.4166666666666667,-4
Hampton,2021,5,308,347,11,0.45454545454545453,-39
Hampton,2022,4,220,298,11,0.36363636363636365,-78
Hampton,2023,5,256,389,11,0.45454545454545453,-133
Hanover College,2020,4,190,101,4,1.0,89
Hanover College,2022,5,340,253,10,0.5,87
Hanover College,2023,7,362,178,10,0.7,184
Hardin-Simmons,2020,4,196,64,5,0.8,132
Hardin-Simmons,2022,9,461,171,11,0.8181818181818182,290
Hardin-Simmons,2023,9,357,219,11,0.8181818181818182,138
Harding University,2021,11,522,167,13,0.8461538461538461,355
Harding University,2022,9,401,218,11,0.8181818181818182,183
Harding University,2023,15,703,163,15,1.0,540
Hartwick,2022,2,154,330,10,0.2,-176
Hartwick,2023,1,120,440,10,0.1,-320
Harvard,2015,9,364,130,10,0.9,234
Harvard,2016,7,262,210,10,0.7,52
Harvard,2017,5,220,209,10,0.5,11
Harvard,2018,6,304,218,10,0.6,86
Harvard,2019,4,296,228,10,0.4,68
Harvard,2021,8,324,149,10,0.8,175
Harvard,2022,6,269,236,10,0.6,33
Harvard,2023,8,318,202,10,0.8,116
Hawai'i,2015,3,229,463,13,0.23076923076923078,-234
Hawai'i,2016,7,396,522,14,0.5,-126
Hawai'i,2017,3,273,407,12,0.25,-134
Hawai'i,2018,8,431,491,14,0.5714285714285714,-60
Hawai'i,2019,10,508,478,15,0.6666666666666666,30
Hawai'i,2020,5,236,248,9,0.5555555555555556,-12
Hawai'i,2021,6,374,408,13,0.46153846153846156,-34
Hawai'i,2022,3,257,451,13,0.23076923076923078,-194
Hawai'i,2023,5,278,419,13,0.38461538461538464,-141
Heidelberg,2020,4,190,78,4,1.0,112
Heidelberg,2022,7,307,162,10,0.7,145
Heidelberg,2023,6,276,241,10,0.6,35
Henderson State,2021,9,446,287,11,0.8181818181818182,159
Henderson State,2022,8,363,287,11,0.7272727272727273,76
Henderson State,2023,9,419,266,12,0.75,153
Hendrix College,2020,3,119,82,4,0.75,37
Hendrix College,2022,3,183,332,10,0.3,-149
Hendrix College,2023,3,294,403,10,0.3,-109
Hilbert College,2022,0,71,377,7,0.0,-306
Hilbert College,2023,0,76,411,8,0.0,-335
Hillsdale,2020,2,97,122,4,0.5,-25
Hillsdale,2021,6,264,261,11,0.5454545454545454,3
Hillsdale,2022,5,258,267,11,0.45454545454545453,-9
Hillsdale,2023,6,330,294,11,0.5454545454545454,36
Hiram College,2022,3,260,369,10,0.3,-109
Hiram College,2023,1,154,432,10,0.1,-278
Hobart College,2022,7,295,128,10,0.7,167
Hobart College,2023,8,312,148,10,0.8,164
Holy Cross,2015,6,351,249,11,0.5454545454545454,102
Holy Cross,2016,4,259,355,11,0.36363636363636365,-96
Holy Cross,2017,4,254,279,11,0.36363636363636365,-25
Holy Cross,2018,5,268,286,11,0.45454545454545453,-18
Holy Cross,2019,7,297,316,13,0.5384615384615384,-19
Holy Cross,2020,3,90,68,4,0.75,22
Holy Cross,2021,10,419,240,13,0.7692307692307693,179
Holy Cross,2022,12,486,279,13,0.9230769230769231,207
Holy Cross,2023,7,406,283,11,0.6363636363636364,123
Hope College,2022,6,318,219,10,0.6,99
Hope College,2023,8,360,232,10,0.8,128
Houston,2015,13,566,290,14,0.9285714285714286,276
Houston,2016,9,466,305,13,0.6923076923076923,161
Houston,2017,7,339,286,12,0.5833333333333334,53
Houston,2018,8,571,483,13,0.6153846153846154,88
Houston,2019,4,368,408,12,0.3333333333333333,-40
Houston,2020,3,240,256,8,0.375,-16
Houston,2021,12,502,286,14,0.8571428571428571,216
Houston,2022,8,469,418,13,0.6153846153846154,51
Houston,2023,4,284,378,12,0.3333333333333333,-94
Houston Christian,2015,1,157,396,10,0.1,-239
Houston Christian,2016,4,207,383,11,0.36363636363636365,-176
Houston Christian,2017,1,150,307,11,0.09090909090909091,-157
Houston Christian,2018,1,301,481,11,0.09090909090909091,-180
Houston Christian,2019,5,429,441,12,0.4166666666666667,-12
Houston Christian,2020,1,135,188,4,0.25,-53
Houston Christian,2021,0,191,459,11,0.0,-268
Houston Christian,2022,2,198,405,11,0.18181818181818182,-207
Houston Christian,2023,6,262,278,11,0.5454545454545454,-16
Howard,2015,1,169,408,11,0.09090909090909091,-239
Howard,2016,2,208,383,11,0.18181818181818182,-175
Howard,2017,7,329,310,11,0.6363636363636364,19
Howard,2018,4,336,341,10,0.4,-5
Howard,2019,2,199,539,12,0.16666666666666666,-340
Howard,2020,0,38,54,2,0.0,-16
Howard,2021,3,260,328,11,0.2727272727272727,-68
Howard,2022,5,311,279,11,0.45454545454545453,32
Howard,2023,6,342,285,12,0.5,57
Howard Payne,2020,2,146,155,5,0.4,-9
Howard Payne,2022,7,398,270,10,0.7,128
Howard Payne,2023,6,344,232,10,0.6,112
Huntingdon College (AL),2020,2,45,58,3,0.6666666666666666,-13
Huntingdon College (AL),2022,9,403,259,11,0.8181818181818182,144
Huntingdon College (AL),2023,8,322,179,10,0.8,143
Husson,2022,5,177,233,10,0.5,-56
Husson,2023,7,345,236,10,0.7,109
Idaho,2015,4,364,505,12,0.3333333333333333,-141
Idaho,2016,9,400,407,13,0.6923076923076923,-7
Idaho,2017,4,251,309,12,0.3333333333333333,-58
Idaho,2018,4,274,412,11,0.36363636363636365,-138
Idaho,2019,5,308,406,12,0.4166666666666667,-98
Idaho,2020,2,140,161,6,0.3333333333333333,-21
Idaho,2021,4,279,347,11,0.36363636363636365,-68
Idaho,2022,7,431,305,12,0.5833333333333334,126
Idaho,2023,9,420,287,13,0.6923076923076923,133
Idaho State,2015,2,242,450,11,0.18181818181818182,-208
Idaho State,2016,1,220,448,10,0.1,-228
Idaho State,2017,4,309,391,11,0.36363636363636365,-82
Idaho State,2018,6,388,363,11,0.5454545454545454,25
Idaho State,2019,3,270,418,12,0.25,-148
Idaho State,2020,2,155,192,6,0.3333333333333333,-37
Idaho State,2021,1,168,375,11,0.09090909090909091,-207
Idaho State,2022,1,151,402,11,0.09090909090909091,-251
Idaho State,2023,3,280,437,11,0.2727272727272727,-157
Illinois,2015,5,272,279,12,0.4166666666666667,-7
Illinois,2016,3,236,383,12,0.25,-147
Illinois,2017,2,185,378,12,0.16666666666666666,-193
Illinois,2018,4,312,473,12,0.3333333333333333,-161
Illinois,2019,6,347,340,13,0.46153846153846156,7
Illinois,2020,2,161,279,8,0.25,-118
Illinois,2021,5,242,263,12,0.4166666666666667,-21
Illinois,2022,8,315,166,13,0.6153846153846154,149
Illinois,2023,5,294,353,12,0.4166666666666667,-59
Illinois College,2020,0,14,21,1,0.0,-7
Illinois College,2022,5,270,211,9,0.5555555555555556,59
Illinois College,2023,9,520,192,11,0.8181818181818182,328
Illinois State,2015,10,451,276,13,0.7692307692307693,175
Illinois State,2016,6,312,262,12,0.5,50
Illinois State,2017,6,287,213,11,0.5454545454545454,74
Illinois State,2018,6,350,220,11,0.5454545454545454,130
Illinois State,2019,10,297,240,15,0.6666666666666666,57
Illinois State,2020,1,69,86,4,0.25,-17
Illinois State,2021,4,202,246,11,0.36363636363636365,-44
Illinois State,2022,6,190,224,11,0.5454545454545454,-34
Illinois State,2023,6,349,213,11,0.5454545454545454,136
Illinois Wesleyan,2020,2,82,45,3,0.6666666666666666,37
Illinois Wesleyan,2022,5,230,276,10,0.5,-46
Illinois Wesleyan,2023,3,248,377,10,0.3,-129
Incarnate Word,2015,5,181,263,10,0.5,-82
Incarnate Word,2016,3,290,415,11,0.2727272727272727,-125
Incarnate Word,2017,1,232,525,11,0.09090909090909091,-293
Incarnate Word,2018,6,357,375,11,0.5454545454545454,-18
Incarnate Word,2019,5,358,417,12,0.4166666666666667,-59
Incarnate Word,2020,3,252,251,6,0.5,1
Incarnate Word,2021,10,513,350,13,0.7692307692307693,163
Incarnate Word,2022,12,721,346,14,0.8571428571428571,375
Incarnate Word,2023,9,337,195,11,0.8181818181818182,142
Indiana,2015,6,475,489,13,0.46153846153846156,-14
Indiana,2016,6,335,354,13,0.46153846153846156,-19
Indiana,2017,5,322,304,12,0.4166666666666667,18
Indiana,2018,5,317,359,12,0.4166666666666667,-42
Indiana,2019,8,413,317,13,0.6153846153846154,96
Indiana,2020,6,231,162,8,0.75,69
Indiana,2021,2,207,399,12,0.16666666666666666,-192
Indiana,2022,4,279,407,12,0.3333333333333333,-128
Indiana,2023,3,266,359,12,0.25,-93
Indiana State,2015,5,305,346,11,0.45454545454545453,-41
Indiana State,2016,4,274,359,11,0.36363636363636365,-85
Indiana State,2017,0,158,494,11,0.0,-336
Indiana State,2018,7,349,310,11,0.6363636363636364,39
Indiana State,2019,5,235,274,12,0.4166666666666667,-39
Indiana State,2021,5,175,330,11,0.45454545454545453,-155
Indiana State,2022,2,176,360,11,0.18181818181818182,-184
Indiana State,2023,1,148,330,11,0.09090909090909091,-182
Indiana Wesleyan,2019,0,27,30,1,0.0,-3
Indiana Wesleyan,2021,1,28,10,1,1.0,18
Indiana Wesleyan,2022,0,17,20,1,0.0,-3
Indiana Wesleyan,2023,1,24,22,1,1.0,2
Indiana-Pennsylvania,2021,7,352,227,10,0.7,125
Indiana-Pennsylvania,2022,10,379,237,12,0.8333333333333334,142
Indiana-Pennsylvania,2023,6,289,217,11,0.5454545454545454,72
Indianapolis,2020,2,89,23,2,1.0,66
Indianapolis,2021,7,412,222,11,0.6363636363636364,190
Indianapolis,2022,9,394,253,11,0.8181818181818182,141
Indianapolis,2023,9,348,164,11,0.8181818181818182,184
Iowa,2015,12,433,285,14,0.8571428571428571,148
Iowa,2016,8,324,245,13,0.6153846153846154,79
Iowa,2017,8,367,259,13,0.6153846153846154,108
Iowa,2018,9,405,231,13,0.6923076923076923,174
Iowa,2019,10,335,182,13,0.7692307692307693,153
Iowa,2020,6,254,128,8,0.75,126
Iowa,2021,10,328,269,14,0.7142857142857143,59
Iowa,2022,8,230,173,13,0.6153846153846154,57
Iowa,2023,10,216,207,14,0.7142857142857143,9
Iowa State,2015,3,300,392,12,0.25,-92
Iowa State,2016,3,332,376,12,0.25,-44
Iowa State,2017,8,380,272,13,0.6153846153846154,108
Iowa State,2018,8,348,298,13,0.6153846153846154,50
Iowa State,2019,7,418,337,13,0.5384615384615384,81
Iowa State,2020,9,395,257,12,0.75,138
Iowa State,2021,7,407,267,13,0.5384615384615384,140
Iowa State,2022,4,242,243,12,0.3333333333333333,-1
Iowa State,2023,7,341,296,13,0.5384615384615384,45
Iowa Wesleyan,2020,1,73,62,3,0.3333333333333333,11
Iowa Wesleyan,2021,0,27,59,1,0.0,-32
Iowa Wesleyan,2022,2,96,6,2,1.0,90
Ithaca College,2022,12,484,187,13,0.9230769230769231,297
Ithaca College,2023,9,306,199,12,0.75,107
Jackson State,2015,2,218,348,10,0.2,-130
Jackson State,2016,3,203,317,11,0.2727272727272727,-114
Jackson State,2017,3,140,284,11,0.2727272727272727,-144
Jackson State,2018,5,165,245,10,0.5,-80
Jackson State,2019,4,313,429,12,0.3333333333333333,-116
Jackson State,2020,4,216,156,7,0.5714285714285714,60
Jackson State,2021,11,358,193,13,0.8461538461538461,165
Jackson State,2022,12,490,176,13,0.9230769230769231,314
Jackson State,2023,7,300,263,11,0.6363636363636364,37
Jacksonville,2015,9,335,210,11,0.8181818181818182,125
Jacksonville,2016,5,326,333,10,0.5,-7
Jacksonville,2017,7,324,385,11,0.6363636363636364,-61
Jacksonville,2018,2,284,387,10,0.2,-103
Jacksonville,2019,3,298,427,12,0.25,-129
Jacksonville State,2015,13,584,299,15,0.8666666666666667,285
Jacksonville State,2016,10,371,219,12,0.8333333333333334,152
Jacksonville State,2017,10,346,180,12,0.8333333333333334,166
Jacksonville State,2018,9,520,323,13,0.6923076923076923,197
Jacksonville State,2019,6,328,331,12,0.5,-3
Jacksonville State,2020,10,369,229,13,0.7692307692307693,140
Jacksonville State,2021,5,242,312,11,0.45454545454545453,-70
Jacksonville State,2022,9,398,252,11,0.8181818181818182,146
Jacksonville State,2023,9,392,275,13,0.6923076923076923,117
James Madison,2015,9,531,344,12,0.75,187
James Madison,2016,14,700,318,15,0.9333333333333333,382
James Madison,2017,14,516,167,15,0.9333333333333333,349
James Madison,2018,9,441,190,13,0.6923076923076923,251
James Madison,2019,14,640,251,16,0.875,389
James Madison,2020,7,269,132,8,0.875,137
James Madison,2021,12,536,216,14,0.8571428571428571,320
James Madison,2022,8,407,230,11,0.7272727272727273,177
James Madison,2023,11,443,253,13,0.8461538461538461,190
John Carroll University,2020,2,89,79,3,0.6666666666666666,10
John Carroll University,2022,8,380,131,10,0.8,249
John Carroll University,2023,8,377,191,10,0.8,186
Johns Hopkins University,2022,9,454,149,10,0.9,305
Johns Hopkins University,2023,12,532,261,13,0.9230769230769231,271
Johnson C Smith,2016,0,0,59,1,0.0,-59
Johnson C Smith,2017,0,0,41,1,0.0,-41
Johnson C Smith,2021,1,117,241,8,0.125,-124
Johnson C Smith,2022,2,227,231,10,0.2,-4
Johnson C Smith,2023,7,240,162,10,0.7,78
Juniata College,2022,0,95,530,10,0.0,-435
Juniata College,2023,1,150,438,10,0.1,-288
Kalamazoo,2020,0,14,68,2,0.0,-54
Kalamazoo,2022,3,210,373,10,0.3,-163
Kalamazoo,2023,5,297,341,10,0.5,-44
Kansas,2015,0,183,553,12,0.0,-370
Kansas,2016,2,243,448,12,0.16666666666666666,-205
Kansas,2017,1,224,521,12,0.08333333333333333,-297
Kansas,2018,3,286,360,12,0.25,-74
Kansas,2019,3,282,433,12,0.25,-151
Kansas,2020,0,142,414,9,0.0,-272
Kansas,2021,2,249,506,12,0.16666666666666666,-257
Kansas,2022,6,463,461,13,0.46153846153846156,2
Kansas,2023,9,452,345,13,0.6923076923076923,107
Kansas State,2015,6,389,409,13,0.46153846153846156,-20
Kansas State,2016,9,419,290,13,0.6923076923076923,129
Kansas State,2017,8,420,327,13,0.6153846153846154,93
Kansas State,2018,5,270,305,12,0.4166666666666667,-35
Kansas State,2019,8,385,278,13,0.6153846153846154,107
Kansas State,2020,4,266,322,10,0.4,-56
Kansas State,2021,8,358,273,13,0.6153846153846154,85
Kansas State,2022,10,452,306,14,0.7142857142857143,146
Kansas State,2023,9,482,273,13,0.6923076923076923,209
Kean,2020,0,12,41,1,0.0,-29
Kean,2022,3,150,181,10,0.3,-31
Kean,2023,0,122,274,10,0.0,-152
Keiser University,2022,0,32,99,3,0.0,-67
Keiser University,2023,0,39,66,2,0.0,-27
Kennesaw State,2015,6,318,233,11,0.5454545454545454,85
Kennesaw State,2016,8,428,239,11,0.7272727272727273,189
Kennesaw State,2017,12,421,217,14,0.8571428571428571,204
Kennesaw State,2018,11,565,200,13,0.8461538461538461,365
Kennesaw State,2019,11,530,262,14,0.7857142857142857,268
Kennesaw State,2020,4,148,91,5,0.8,57
Kennesaw State,2021,11,427,253,13,0.8461538461538461,174
Kennesaw State,2022,5,302,385,11,0.45454545454545453,-83
Kennesaw State,2023,3,235,161,9,0.3333333333333333,74
Kent State,2015,3,157,313,12,0.25,-156
Kent State,2016,3,247,344,12,0.25,-97
Kent State,2017,2,153,421,12,0.16666666666666666,-268
Kent State,2018,2,287,440,12,0.16666666666666666,-153
Kent State,2019,7,380,414,13,0.5384615384615384,-34
Kent State,2020,3,199,152,4,0.75,47
Kent State,2021,7,462,508,14,0.5,-46
Kent State,2022,5,341,348,12,0.4166666666666667,-7
Kent State,2023,1,176,415,12,0.08333333333333333,-239
Kentucky,2015,5,296,329,12,0.4166666666666667,-33
Kentucky,2016,7,390,407,13,0.5384615384615384,-17
Kentucky,2017,7,332,367,13,0.5384615384615384,-35
Kentucky,2018,10,346,219,13,0.7692307692307693,127
Kentucky,2019,8,353,251,13,0.6153846153846154,102
Kentucky,2020,5,240,285,11,0.45454545454545453,-45
Kentucky,2021,10,420,282,13,0.7692307692307693,138
Kentucky,2022,7,265,250,13,0.5384615384615384,15
Kentucky,2023,7,378,336,13,0.5384615384615384,42
Kentucky Christian,2015,0,7,47,1,0.0,-40
Kentucky Christian,2017,0,14,56,1,0.0,-42
Kentucky Christian,2018,0,7,70,1,0.0,-63
Kentucky Christian,2019,0,34,73,1,0.0,-39
Kentucky Christian,2022,0,14,49,1,0.0,-35
Kentucky State,2015,0,20,35,1,0.0,-15
Kentucky State,2016,0,7,57,1,0.0,-50
Kentucky State,2017,0,13,21,1,0.0,-8
Kentucky State,2019,2,46,32,2,1.0,14
Kentucky State,2021,7,395,252,11,0.6363636363636364,143
Kentucky State,2022,4,206,255,10,0.4,-49
Kentucky State,2023,3,185,337,10,0.3,-152
Kentucky Wesleyan,2015,0,46,108,3,0.0,-62
Kentucky Wesleyan,2016,0,28,84,2,0.0,-56
Kentucky Wesleyan,2017,0,7,67,1,0.0,-60
Kentucky Wesleyan,2020,1,52,126,5,0.2,-74
Kentucky Wesleyan,2021,3,254,318,11,0.2727272727272727,-64
Kentucky Wesleyan,2022,2,149,425,11,0.18181818181818182,-276
Kentucky Wesleyan,2023,4,242,372,11,0.36363636363636365,-130
Kenyon,2022,2,243,346,9,0.2222222222222222,-103
Kenyon,2023,2,214,462,10,0.2,-248
Keystone,2022,3,271,410,10,0.3,-139
Keystone,2023,2,182,379,10,0.2,-197
Kings College (PA),2022,8,256,206,10,0.8,50
Kings College (PA),2023,8,285,153,10,0.8,132
Knox College,2022,5,198,266,10,0.5,-68
Knox College,2023,3,147,344,10,0.3,-197
Kutztown University,2021,11,330,190,13,0.8461538461538461,140
Kutztown University,2022,8,273,194,11,0.7272727272727273,79
Kutztown University,2023,12,361,250,15,0.8,111
LAKELAND,2023,0,20,23,1,0.0,-3
LSU,2015,9,394,291,12,0.75,103
LSU,2016,8,340,189,12,0.6666666666666666,151
LSU,2017,9,354,246,13,0.6923076923076923,108
LSU,2018,10,421,283,13,0.7692307692307693,138
LSU,2019,15,726,328,15,1.0,398
LSU,2020,5,320,349,10,0.5,-29
LSU,2021,6,345,346,13,0.46153846153846156,-1
LSU,2022,10,483,315,14,0.7142857142857143,168
LSU,2023,10,592,364,13,0.7692307692307693,228
LYONCOLL,2023,4,163,293,8,0.5,-130
La Verne,2022,2,152,398,10,0.2,-246
La Verne,2023,2,135,309,10,0.2,-174
Lafayette,2015,1,150,386,11,0.09090909090909091,-236
Lafayette,2016,2,216,386,11,0.18181818181818182,-170
Lafayette,2017,3,132,299,11,0.2727272727272727,-167
Lafayette,2018,3,143,323,11,0.2727272727272727,-180
Lafayette,2019,4,221,319,12,0.3333333333333333,-98
Lafayette,2020,2,57,61,3,0.6666666666666666,-4
Lafayette,2021,3,182,259,11,0.2727272727272727,-77
Lafayette,2022,4,139,239,11,0.36363636363636365,-100
Lafayette,2023,9,360,280,12,0.75,80
Lagrange College,2022,1,175,409,9,0.1111111111111111,-234
Lagrange College,2023,0,132,347,9,0.0,-215
Lake Erie,2020,0,31,102,3,0.0,-71
Lake Erie,2021,5,245,295,11,0.45454545454545453,-50
Lake Erie,2022,2,246,375,11,0.18181818181818182,-129
Lake Erie,2023,1,167,451,11,0.09090909090909091,-284
Lake Forest College,2020,3,86,26,3,1.0,60
Lake Forest College,2022,8,356,121,10,0.8,235
Lake Forest College,2023,7,344,56,10,0.7,288
Lakeland,2020,3,116,31,3,1.0,85
Lakeland,2022,3,260,321,10,0.3,-61
Lakeland,2023,4,223,349,10,0.4,-126
Lamar,2015,5,394,334,11,0.45454545454545453,60
Lamar,2016,3,230,336,11,0.2727272727272727,-106
Lamar,2017,1,175,385,10,0.1,-210
Lamar,2018,7,371,340,12,0.5833333333333334,31
Lamar,2019,4,265,380,12,0.3333333333333333,-115
Lamar,2020,2,97,250,6,0.3333333333333333,-153
Lamar,2021,1,123,398,10,0.1,-275
Lamar,2022,1,232,415,11,0.09090909090909091,-183
Lamar,2023,6,270,259,11,0.5454545454545454,11
Lane College,2015,0,3,7,1,0.0,-4
Lane College,2018,0,8,41,1,0.0,-33
Lane College,2019,0,38,79,2,0.0,-41
Lane College,2021,6,306,267,10,0.6,39
Lane College,2022,5,300,277,10,0.5,23
Lane College,2023,2,227,335,10,0.2,-108
Langston University,2018,0,18,33,1,0.0,-15
Langston University,2019,0,15,53,1,0.0,-38
Laurinburg,2021,0,43,84,1,0.0,-41
Laurinburg,2022,0,6,56,1,0.0,-50
Laurinburg,2023,0,6,84,1,0.0,-78
Lawrence Tech,2021,1,21,14,1,1.0,7
Lawrence University,2022,0,39,511,10,0.0,-472
Lawrence University,2023,0,146,513,10,0.0,-367
Lebanon Valley,2020,2,74,29,2,1.0,45
Lebanon Valley,2022,5,242,216,10,0.5,26
Lebanon Valley,2023,6,300,207,10,0.6,93
Lehigh,2015,6,355,388,11,0.5454545454545454,-33
Lehigh,2016,9,466,323,12,0.75,143
Lehigh,2017,5,430,492,12,0.4166666666666667,-62
Lehigh,2018,3,183,386,11,0.2727272727272727,-203
Lehigh,2019,4,173,235,11,0.36363636363636365,-62
Lehigh,2020,0,16,46,3,0.0,-30
Lehigh,2021,3,127,285,11,0.2727272727272727,-158
Lehigh,2022,2,189,325,11,0.18181818181818182,-136
Lehigh,2023,2,203,343,11,0.18181818181818182,-140
Lenoir-Rhyne,2020,3,138,82,4,0.75,56
Lenoir-Rhyne,2021,8,423,180,11,0.7272727272727273,243
Lenoir-Rhyne,2022,8,387,205,11,0.7272727272727273,182
Lenoir-Rhyne,2023,13,566,220,15,0.8666666666666667,346
Lewis & Clark College,2022,4,288,366,9,0.4444444444444444,-78
Lewis & Clark College,2023,5,356,369,10,0.5,-13
Liberty,2015,6,285,296,11,0.5454545454545454,-11
Liberty,2016,6,302,286,11,0.5454545454545454,16
Liberty,2017,6,358,334,11,0.5454545454545454,24
Liberty,2018,6,399,442,12,0.5,-43
Liberty,2019,8,427,365,13,0.6153846153846154,62
Liberty,2020,10,420,226,11,0.9090909090909091,194
Liberty,2021,8,437,280,13,0.6153846153846154,157
Liberty,2022,8,358,320,13,0.6153846153846154,38
Liberty,2023,13,536,340,14,0.9285714285714286,196
Limestone,2017,0,10,31,1,0.0,-21
Limestone,2018,0,17,52,1,0.0,-35
Limestone,2020,1,99,142,4,0.25,-43
Limestone,2021,0,119,315,9,0.0,-196
Limestone,2022,8,417,373,12,0.6666666666666666,44
Limestone,2023,8,363,302,12,0.6666666666666666,61
Lincoln (CA),2021,0,62,458,7,0.0,-396
Lincoln (CA),2022,2,142,418,10,0.2,-276
Lincoln (CA),2023,0,93,423,11,0.0,-330
Lincoln (MO),2018,0,24,52,1,0.0,-28
Lincoln (MO),2020,0,3,87,1,0.0,-84
Lincoln (MO),2021,0,195,551,9,0.0,-356
Lincoln (MO),2022,0,129,526,11,0.0,-397
Lincoln (MO),2023,0,122,591,11,0.0,-469
Lincoln (PA),2016,0,6,56,1,0.0,-50
Lincoln (PA),2018,0,0,55,1,0.0,-55
Lincoln (PA),2019,0,12,58,1,0.0,-46
Lincoln (PA),2021,1,61,310,10,0.1,-249
Lincoln (PA),2022,2,160,267,10,0.2,-107
Lincoln (PA),2023,4,278,379,10,0.4,-101
Lindenwood,2019,0,31,59,1,0.0,-28
Lindenwood,2021,9,395,311,12,0.75,84
Lindenwood,2022,7,395,322,10,0.7,73
Lindenwood,2023,3,220,315,10,0.3,-95
Lindsey Wilson College,2018,0,0,10,1,0.0,-10
Linfield College,2021,1,56,20,1,1.0,36
Linfield College,2022,10,492,148,11,0.9090909090909091,344
Linfield College,2023,8,376,146,9,0.8888888888888888,230
Little Rock,2021,0,0,71,1,0.0,-71
Little Rock,2023,0,0,66,1,0.0,-66
Livingstone,2016,0,12,38,1,0.0,-26
Livingstone,2017,0,0,59,1,0.0,-59
Livingstone,2021,1,91,247,9,0.1111111111111111,-156
Livingstone,2022,4,137,292,10,0.4,-155
Livingstone,2023,4,188,293,10,0.4,-105
Lock Haven University,2017,0,3,69,1,0.0,-66
Lock Haven University,2018,0,0,45,1,0.0,-45
Lock Haven University,2021,1,147,489,11,0.09090909090909091,-342
Lock Haven University,2022,1,121,469,11,0.09090909090909091,-348
Lock Haven University,2023,5,279,266,11,0.45454545454545453,13
Long Island University,2019,0,97,289,10,0.0,-192
Long Island University,2020,2,79,109,4,0.5,-30
Long Island University,2021,2,139,405,10,0.2,-266
Long Island University,2022,4,266,417,11,0.36363636363636365,-151
Long Island University,2023,4,216,290,11,0.36363636363636365,-74
Loras College,2020,2,106,34,2,1.0,72
Loras College,2022,5,348,282,10,0.5,66
Loras College,2023,5,344,376,10,0.5,-32
Louisiana,2015,4,317,382,12,0.3333333333333333,-65
Louisiana,2016,6,307,329,13,0.46153846153846156,-22
Louisiana,2017,5,338,480,12,0.4166666666666667,-142
Louisiana,2018,7,447,479,14,0.5,-32
Louisiana,2019,11,531,276,14,0.7857142857142857,255
Louisiana,2020,10,370,242,11,0.9090909090909091,128
Louisiana,2021,13,435,259,14,0.9285714285714286,176
Louisiana,2022,6,340,297,13,0.46153846153846156,43
Louisiana,2023,6,418,372,13,0.46153846153846156,46
Louisiana College,2018,0,0,78,1,0.0,-78
Louisiana College,2019,0,13,58,1,0.0,-45
Louisiana College,2020,2,132,178,5,0.4,-46
Louisiana College,2021,0,7,62,1,0.0,-55
Louisiana College,2022,0,14,45,1,0.0,-31
Louisiana College,2023,1,34,14,1,1.0,20
Louisiana Tech,2015,9,488,349,13,0.6923076923076923,139
Louisiana Tech,2016,9,620,470,14,0.6428571428571429,150
Louisiana Tech,2017,7,396,330,13,0.5384615384615384,66
Louisiana Tech,2018,8,321,299,13,0.6153846153846154,22
Louisiana Tech,2019,10,422,284,13,0.7692307692307693,138
Louisiana Tech,2020,5,267,347,10,0.5,-80
Louisiana Tech,2021,3,336,408,12,0.25,-72
Louisiana Tech,2022,3,348,455,12,0.25,-107
Louisiana Tech,2023,3,311,401,12,0.25,-90
Louisville,2015,8,373,313,13,0.6153846153846154,60
Louisville,2016,9,553,309,13,0.6923076923076923,244
Louisville,2017,8,495,356,13,0.6153846153846154,139
Louisville,2018,2,237,529,12,0.16666666666666666,-292
Louisville,2019,8,430,434,13,0.6153846153846154,-4
Louisville,2020,4,325,293,11,0.36363636363636365,32
Louisville,2021,6,411,355,13,0.46153846153846156,56
Louisville,2022,8,350,249,13,0.6153846153846154,101
Louisville,2023,10,430,298,14,0.7142857142857143,132
Luther,2020,0,21,45,1,0.0,-24
Luther,2022,2,201,474,10,0.2,-273
Luther,2023,0,133,433,10,0.0,-300
Lycoming,2020,1,30,7,1,1.0,23
Lycoming,2022,4,206,209,10,0.4,-3
Lycoming,2023,4,260,360,10,0.4,-100
MARIAN (IN,2021,0,10,34,1,0.0,-24
MIT,2022,3,156,180,9,0.3333333333333333,-24
MIT,2023,4,191,258,9,0.4444444444444444,-67
MONTANASTN,2021,0,3,30,1,0.0,-27
Macalester,2022,4,275,321,9,0.4444444444444444,-46
Macalester,2023,3,271,371,10,0.3,-100
Madonna University,2022,0,0,38,1,0.0,-38
Madonna University (Mich.),2023,0,0,89,1,0.0,-89
Maine,2015,3,164,237,11,0.2727272727272727,-73
Maine,2016,6,245,288,11,0.5454545454545454,-43
Maine,2017,4,246,233,10,0.4,13
Maine,2018,10,371,327,14,0.7142857142857143,44
Maine,2019,6,352,353,12,0.5,-1
Maine,2020,2,90,134,4,0.5,-44
Maine,2021,6,275,297,11,0.5454545454545454,-22
Maine,2022,2,256,347,11,0.18181818181818182,-91
Maine,2023,2,259,360,11,0.18181818181818182,-101
Malone,2016,0,29,73,2,0.0,-44
Manchester,2020,0,102,220,5,0.0,-118
Manchester,2022,1,189,379,10,0.1,-190
Manchester,2023,1,104,445,10,0.1,-341
Marietta,2020,2,72,81,4,0.5,-9
Marietta,2022,6,257,232,10,0.6,25
Marietta,2023,8,320,167,10,0.8,153
Marist,2015,5,250,224,11,0.45454545454545453,26
Marist,2016,5,276,321,11,0.45454545454545453,-45
Marist,2017,4,234,338,11,0.36363636363636365,-104
Marist,2018,5,282,293,11,0.45454545454545453,-11
Marist,2019,4,237,381,11,0.36363636363636365,-144
Marist,2021,5,228,229,10,0.5,-1
Marist,2022,4,236,327,11,0.36363636363636365,-91
Marist,2023,4,191,326,11,0.36363636363636365,-135
Mars Hill,2015,0,48,86,2,0.0,-38
Mars Hill,2016,0,7,77,1,0.0,-70
Mars Hill,2017,0,0,56,1,0.0,-56
Mars Hill,2018,0,7,28,1,0.0,-21
Mars Hill,2019,0,21,63,1,0.0,-42
Mars Hill,2020,1,90,133,3,0.3333333333333333,-43
Mars Hill,2021,8,353,211,11,0.7272727272727273,142
Mars Hill,2022,7,287,196,10,0.7,91
Mars Hill,2023,8,269,166,10,0.8,103
Marshall,2015,10,407,231,13,0.7692307692307693,176
Marshall,2016,3,317,423,12,0.25,-106
Marshall,2017,8,347,259,13,0.6153846153846154,88
Marshall,2018,9,367,284,13,0.6923076923076923,83
Marshall,2019,8,335,325,13,0.6153846153846154,10
Marshall,2020,7,285,130,10,0.7,155
Marshall,2021,7,429,309,13,0.5384615384615384,120
Marshall,2022,9,318,208,13,0.6923076923076923,110
Marshall,2023,6,296,373,13,0.46153846153846156,-77
Martin Luther,2020,3,138,85,4,0.75,53
Martin Luther,2022,2,128,333,10,0.2,-205
Martin Luther,2023,2,198,371,10,0.2,-173
Mary Hardin-Baylor,2016,1,10,7,1,1.0,3
Mary Hardin-Baylor,2017,0,0,12,1,0.0,-12
Mary Hardin-Baylor,2018,1,24,16,1,1.0,8
Mary Hardin-Baylor,2020,5,211,70,5,1.0,141
Mary Hardin-Baylor,2021,1,57,24,1,1.0,33
Mary Hardin-Baylor,2022,12,578,240,14,0.8571428571428571,338
Mary Hardin-Baylor,2023,6,313,200,10,0.6,113
Maryland,2015,3,296,413,12,0.25,-117
Maryland,2016,6,335,384,13,0.46153846153846156,-49
Maryland,2017,4,289,445,12,0.3333333333333333,-156
Maryland,2018,5,342,344,12,0.4166666666666667,-2
Maryland,2019,3,303,416,12,0.25,-113
Maryland,2020,2,118,160,5,0.4,-42
Maryland,2021,7,381,399,13,0.5384615384615384,-18
Maryland,2022,8,366,301,13,0.6153846153846154,65
Maryland,2023,8,386,292,13,0.6153846153846154,94
Maryville College (TN),2015,1,28,21,1,1.0,7
Maryville College (TN),2020,0,16,30,2,0.0,-14
Maryville College (TN),2022,5,336,221,10,0.5,115
Maryville College (TN),2023,8,323,160,10,0.8,163
Mass Maritime,2022,3,145,196,10,0.3,-51
Mass Maritime,2023,2,120,251,10,0.2,-131
Massachusetts,2015,3,266,377,12,0.25,-111
Massachusetts,2016,2,280,426,12,0.16666666666666666,-146
Massachusetts,2017,4,367,382,12,0.3333333333333333,-15
Massachusetts,2018,4,394,515,12,0.3333333333333333,-121
Massachusetts,2019,1,237,632,12,0.08333333333333333,-395
Massachusetts,2020,0,12,161,4,0.0,-149
Massachusetts,2021,1,196,517,12,0.08333333333333333,-321
Massachusetts,2022,1,150,373,12,0.08333333333333333,-223
Massachusetts,2023,3,278,454,12,0.25,-176
Mayville State,2019,0,7,76,1,0.0,-69
Mayville State,2020,0,31,39,1,0.0,-8
Mayville State,2021,0,7,52,1,0.0,-45
Mayville State,2022,2,86,72,2,1.0,14
Mayville State,2023,1,75,53,2,0.5,22
McDaniel College,2022,3,139,333,10,0.3,-194
McDaniel College,2023,0,145,428,10,0.0,-283
McKendree,2016,0,16,28,1,0.0,-12
McKendree,2020,1,53,59,2,0.5,-6
McKendree,2021,2,245,362,9,0.2222222222222222,-117
McKendree,2022,5,394,463,11,0.45454545454545453,-69
McKendree,2023,5,233,347,10,0.5,-114
McMurry,2020,2,80,169,5,0.4,-89
McMurry,2022,1,157,327,10,0.1,-170
McMurry,2023,6,331,209,10,0.6,122
McNeese,2015,9,295,138,10,0.9,157
McNeese,2016,6,352,285,11,0.5454545454545454,67
McNeese,2017,8,286,167,10,0.8,119
McNeese,2018,6,229,266,11,0.5454545454545454,-37
McNeese,2019,7,313,311,12,0.5833333333333334,2
McNeese,2020,3,183,202,7,0.42857142857142855,-19
McNeese,2021,4,270,280,11,0.36363636363636365,-10
McNeese,2022,4,249,340,11,0.36363636363636365,-91
McNeese,2023,0,191,374,10,0.0,-183
Memphis,2015,9,522,355,13,0.6923076923076923,167
Memphis,2016,8,505,375,13,0.6153846153846154,130
Memphis,2017,10,592,422,13,0.7692307692307693,170
Memphis,2018,8,601,447,14,0.5714285714285714,154
Memphis,2019,12,566,370,14,0.8571428571428571,196
Memphis,2020,8,341,307,11,0.7272727272727273,34
Memphis,2021,6,361,351,12,0.5,10
Memphis,2022,7,459,338,13,0.5384615384615384,121
Memphis,2023,10,512,374,13,0.7692307692307693,138
Mercer,2015,5,318,238,11,0.45454545454545453,80
Mercer,2016,6,298,318,11,0.5454545454545454,-20
Mercer,2017,5,270,260,11,0.45454545454545453,10
Mercer,2018,5,337,357,11,0.45454545454545453,-20
Mercer,2019,4,323,425,12,0.3333333333333333,-102
Mercer,2020,5,265,330,11,0.45454545454545453,-65
Mercer,2021,7,317,227,10,0.7,90
Mercer,2022,7,420,243,11,0.6363636363636364,177
Mercer,2023,9,317,311,13,0.6923076923076923,6
Merchant Marine Academy,2022,6,228,159,9,0.6666666666666666,69
Merchant Marine Academy,2023,7,284,213,9,0.7777777777777778,71
Mercyhurst,2020,0,35,66,2,0.0,-31
Mercyhurst,2021,4,184,270,11,0.36363636363636365,-86
Mercyhurst,2022,2,239,304,11,0.18181818181818182,-65
Mercyhurst,2023,2,243,462,11,0.18181818181818182,-219
Merrimack,2016,0,20,41,1,0.0,-21
Merrimack,2017,0,41,49,1,0.0,-8
Merrimack,2019,6,341,231,11,0.5454545454545454,110
Merrimack,2020,0,36,71,3,0.0,-35
Merrimack,2021,5,306,302,11,0.45454545454545453,4
Merrimack,2022,8,306,251,11,0.7272727272727273,55
Merrimack,2023,5,295,236,11,0.45454545454545453,59
Methodist,2017,0,0,70,1,0.0,-70
Methodist,2020,4,159,66,4,1.0,93
Methodist,2022,5,311,281,10,0.5,30
Methodist,2023,2,190,388,10,0.2,-198
Miami,2015,8,361,366,13,0.6153846153846154,-5
Miami,2016,9,446,241,13,0.6923076923076923,205
Miami,2017,10,378,273,13,0.7692307692307693,105
Miami,2018,7,374,253,13,0.5384615384615384,121
Miami,2019,6,334,263,13,0.46153846153846156,71
Miami,2020,8,374,297,11,0.7272727272727273,77
Miami,2021,7,409,341,12,0.5833333333333334,68
Miami,2022,5,283,321,12,0.4166666666666667,-38
Miami,2023,7,409,296,13,0.5384615384615384,113
Miami (OH),2015,3,215,384,12,0.25,-169
Miami (OH),2016,6,297,309,13,0.46153846153846156,-12
Miami (OH),2017,5,293,289,12,0.4166666666666667,4
Miami (OH),2018,6,337,306,12,0.5,31
Miami (OH),2019,8,338,394,14,0.5714285714285714,-56
Miami (OH),2020,2,86,80,3,0.6666666666666666,6
Miami (OH),2021,7,376,300,13,0.5384615384615384,76
Miami (OH),2022,6,263,294,13,0.46153846153846156,-31
Miami (OH),2023,11,359,223,14,0.7857142857142857,136
Michigan,2015,10,408,213,13,0.7692307692307693,195
Michigan,2016,10,524,183,13,0.7692307692307693,341
Michigan,2017,8,328,245,13,0.6153846153846154,83
Michigan,2018,10,457,252,13,0.7692307692307693,205
Michigan,2019,9,412,269,13,0.6923076923076923,143
Michigan,2020,2,170,207,6,0.3333333333333333,-37
Michigan,2021,12,501,243,14,0.8571428571428571,258
Michigan,2022,13,566,225,14,0.9285714285714286,341
Michigan,2023,15,538,156,15,1.0,382
Michigan State,2015,12,417,304,14,0.8571428571428571,113
Michigan State,2016,3,289,333,12,0.25,-44
Michigan State,2017,10,319,260,13,0.7692307692307693,59
Michigan State,2018,7,243,223,13,0.5384615384615384,20
Michigan State,2019,7,291,293,13,0.5384615384615384,-2
Michigan State,2020,2,126,246,7,0.2857142857142857,-120
Michigan State,2021,11,414,329,13,0.8461538461538461,85
Michigan State,2022,5,293,329,12,0.4166666666666667,-36
Michigan State,2023,4,191,340,12,0.3333333333333333,-149
Michigan Tech,2021,6,200,186,10,0.6,14
Michigan Tech,2022,4,242,330,11,0.36363636363636365,-88
Michigan Tech,2023,5,278,242,10,0.5,36
Middle Tennessee,2015,7,442,346,13,0.5384615384615384,96
Middle Tennessee,2016,8,516,465,13,0.6153846153846154,51
Middle Tennessee,2017,7,332,321,13,0.5384615384615384,11
Middle Tennessee,2018,8,392,374,14,0.5714285714285714,18
Middle Tennessee,2019,4,316,359,12,0.3333333333333333,-43
Middle Tennessee,2020,3,206,319,9,0.3333333333333333,-113
Middle Tennessee,2021,7,388,334,13,0.5384615384615384,54
Middle Tennessee,2022,8,375,360,13,0.6153846153846154,15
Middle Tennessee,2023,4,291,337,12,0.3333333333333333,-46
Middlebury,2022,7,254,204,9,0.7777777777777778,50
Middlebury,2023,8,251,135,9,0.8888888888888888,116
Midwestern State,2019,1,33,7,1,1.0,26
Midwestern State,2020,0,21,33,1,0.0,-12
Midwestern State,2021,7,309,213,10,0.7,96
Midwestern State,2022,6,333,297,11,0.5454545454545454,36
Midwestern State,2023,4,214,206,10,0.4,8
Miles College,2015,0,7,26,1,0.0,-19
Miles College,2016,0,20,53,1,0.0,-33
Miles College,2017,0,21,50,1,0.0,-29
Miles College,2021,6,283,212,10,0.6,71
Miles College,2022,1,138,279,10,0.1,-141
Miles College,2023,7,303,211,10,0.7,92
Millersville,2021,2,165,345,11,0.18181818181818182,-180
Millersville,2022,5,196,257,11,0.45454545454545453,-61
Millersville,2023,3,230,287,11,0.2727272727272727,-57
Millikin,2020,2,97,103,3,0.6666666666666666,-6
Millikin,2022,4,133,363,10,0.4,-230
Millikin,2023,0,78,463,10,0.0,-385
Millsaps,2020,1,78,114,4,0.25,-36
Millsaps,2022,3,146,383,10,0.3,-237
Millsaps,2023,1,133,453,10,0.1,-320
Minnesota,2015,6,292,327,13,0.46153846153846156,-35
Minnesota,2016,9,381,287,13,0.6923076923076923,94
Minnesota,2017,5,265,274,12,0.4166666666666667,-9
Minnesota,2018,7,376,345,13,0.5384615384615384,31
Minnesota,2019,11,443,293,13,0.8461538461538461,150
Minnesota,2020,3,191,211,7,0.42857142857142855,-20
Minnesota,2021,9,331,225,13,0.6923076923076923,106
Minnesota,2022,9,367,180,13,0.6923076923076923,187
Minnesota,2023,6,272,347,13,0.46153846153846156,-75
Minnesota Duluth,2021,9,391,300,12,0.75,91
Minnesota Duluth,2022,8,367,206,11,0.7272727272727273,161
Minnesota Duluth,2023,9,415,205,11,0.8181818181818182,210
Minnesota Morris,2020,0,37,71,2,0.0,-34
Minnesota Morris,2022,4,253,260,10,0.4,-7
Minnesota Morris,2023,7,346,327,11,0.6363636363636364,19
Minnesota State Mankato,2019,0,40,48,1,0.0,-8
Minnesota State Mankato,2021,6,441,251,11,0.5454545454545454,190
Minnesota State Mankato,2022,10,437,303,13,0.7692307692307693,134
Minnesota State Mankato,2023,9,409,300,12,0.75,109
Minnesota State Moorhead,2021,5,272,275,11,0.45454545454545453,-3
Minnesota State Moorhead,2022,4,198,318,11,0.36363636363636365,-120
Minnesota State Moorhead,2023,7,366,251,11,0.6363636363636364,115
Minot State,2021,2,194,396,10,0.2,-202
Minot State,2022,1,133,380,11,0.09090909090909091,-247
Minot State,2023,1,150,366,11,0.09090909090909091,-216
Misericordia,2020,0,7,30,1,0.0,-23
Misericordia,2022,3,133,274,10,0.3,-141
Misericordia,2023,4,185,224,10,0.4,-39
Mississippi College,2015,0,0,37,1,0.0,-37
Mississippi College,2018,0,17,34,1,0.0,-17
Mississippi College,2019,0,7,45,1,0.0,-38
Mississippi College,2020,0,14,39,1,0.0,-25
Mississippi College,2021,4,265,275,10,0.4,-10
Mississippi College,2022,4,291,399,11,0.36363636363636365,-108
Mississippi College,2023,3,181,265,10,0.3,-84
Mississippi State,2015,9,447,302,13,0.6923076923076923,145
Mississippi State,2016,6,395,413,13,0.46153846153846156,-18
Mississippi State,2017,9,416,272,13,0.6923076923076923,144
Mississippi State,2018,8,371,171,13,0.6153846153846154,200
Mississippi State,2019,6,359,375,13,0.46153846153846156,-16
Mississippi State,2020,4,235,309,11,0.36363636363636365,-74
Mississippi State,2021,7,378,337,13,0.5384615384615384,41
Mississippi State,2022,9,411,300,13,0.6923076923076923,111
Mississippi State,2023,5,262,319,12,0.4166666666666667,-57
Mississippi Valley State,2015,0,113,392,9,0.0,-279
Mississippi Valley State,2016,1,154,504,11,0.09090909090909091,-350
Mississippi Valley State,2017,2,164,445,11,0.18181818181818182,-281
Mississippi Valley State,2018,1,219,466,11,0.09090909090909091,-247
Mississippi Valley State,2019,2,178,319,11,0.18181818181818182,-141
Mississippi Valley State,2020,1,43,109,4,0.25,-66
Mississippi Valley State,2021,4,216,336,11,0.36363636363636365,-120
Mississippi Valley State,2022,2,159,334,11,0.18181818181818182,-175
Mississippi Valley State,2023,1,132,298,11,0.09090909090909091,-166
Missouri,2015,5,163,194,12,0.4166666666666667,-31
Missouri,2016,4,377,378,12,0.3333333333333333,-1
Missouri,2017,7,488,414,13,0.5384615384615384,74
Missouri,2018,8,476,331,13,0.6153846153846154,145
Missouri,2019,6,304,233,12,0.5,71
Missouri,2020,5,267,323,10,0.5,-56
Missouri,2021,6,378,440,13,0.46153846153846156,-62
Missouri,2022,6,323,327,13,0.46153846153846156,-4
Missouri,2023,11,423,271,13,0.8461538461538461,152
Missouri S&T,2016,0,16,49,1,0.0,-33
Missouri S&T,2018,0,12,52,1,0.0,-40
Missouri S&T,2019,1,23,20,1,1.0,3
Missouri S&T,2020,2,124,108,3,0.6666666666666666,16
Missouri S&T,2021,6,396,345,11,0.5454545454545454,51
Missouri S&T,2022,3,207,267,10,0.3,-60
Missouri S&T,2023,4,303,284,11,0.36363636363636365,19
Missouri Southern State,2021,3,234,347,11,0.2727272727272727,-113
Missouri Southern State,2022,4,238,273,11,0.36363636363636365,-35
Missouri Southern State,2023,5,343,314,11,0.45454545454545453,29
Missouri State,2015,1,108,535,11,0.09090909090909091,-427
Missouri State,2016,4,257,393,11,0.36363636363636365,-136
Missouri State,2017,3,266,421,11,0.2727272727272727,-155
Missouri State,2018,4,253,396,11,0.36363636363636365,-143
Missouri State,2019,1,170,397,11,0.09090909090909091,-227
Missouri State,2020,5,175,268,10,0.5,-93
Missouri State,2021,8,411,314,12,0.6666666666666666,97
Missouri State,2022,5,301,300,11,0.45454545454545453,1
Missouri State,2023,4,328,333,11,0.36363636363636365,-5
Missouri Western,2020,0,10,52,1,0.0,-42
Missouri Western,2021,6,374,330,11,0.5454545454545454,44
Missouri Western,2022,5,282,259,11,0.45454545454545453,23
Missouri Western,2023,8,422,270,11,0.7272727272727273,152
Monmouth,2015,5,226,277,11,0.45454545454545453,-51
Monmouth,2016,4,280,361,11,0.36363636363636365,-81
Monmouth,2017,9,394,331,12,0.75,63
Monmouth,2018,8,365,347,11,0.7272727272727273,18
Monmouth,2019,11,501,381,14,0.7857142857142857,120
Monmouth,2020,3,140,74,4,0.75,66
Monmouth,2021,7,354,302,11,0.6363636363636364,52
Monmouth,2022,5,400,377,11,0.45454545454545453,23
Monmouth,2023,4,357,303,11,0.36363636363636365,54
Monmouth (IL),2022,8,420,154,10,0.8,266
Monmouth (IL),2023,8,435,140,10,0.8,295
Montana,2015,8,381,320,13,0.6153846153846154,61
Montana,2016,6,434,297,11,0.5454545454545454,137
Montana,2017,7,385,319,11,0.6363636363636364,66
Montana,2018,6,373,314,11,0.5454545454545454,59
Montana,2019,10,514,351,14,0.7142857142857143,163
Montana,2020,2,107,10,2,1.0,97
Montana,2021,10,385,212,13,0.7692307692307693,173
Montana,2022,8,470,277,13,0.6153846153846154,193
Montana,2023,13,454,258,15,0.8666666666666667,196
Montana State,2015,5,461,377,11,0.45454545454545453,84
Montana State,2016,4,282,276,11,0.36363636363636365,6
Montana State,2017,5,278,275,11,0.45454545454545453,3
Montana State,2018,8,370,370,13,0.6153846153846154,0
Montana State,2019,11,490,331,15,0.7333333333333333,159
Montana State,2021,12,430,226,15,0.8,204
Montana State,2022,12,601,366,14,0.8571428571428571,235
Montana State,2023,8,479,262,12,0.6666666666666666,217
Montana Tech,2023,1,37,29,1,1.0,8
Montana-Western,2017,0,0,76,1,0.0,-76
Montana-Western,2023,1,48,13,1,1.0,35
Montclair State,2020,2,82,32,3,0.6666666666666666,50
Montclair State,2022,2,142,173,10,0.2,-31
Montclair State,2023,5,206,240,10,0.5,-34
Moravian,2022,3,165,323,10,0.3,-158
Moravian,2023,4,258,316,10,0.4,-58
Morehead State,2015,6,281,278,10,0.6,3
Morehead State,2016,4,356,380,11,0.36363636363636365,-24
Morehead State,2017,4,266,448,11,0.36363636363636365,-182
Morehead State,2018,3,303,475,11,0.2727272727272727,-172
Morehead State,2019,5,345,415,12,0.4166666666666667,-70
Morehead State,2020,4,159,177,7,0.5714285714285714,-18
Morehead State,2021,7,360,348,11,0.6363636363636364,12
Morehead State,2022,2,253,406,11,0.18181818181818182,-153
Morehead State,2023,4,243,318,11,0.36363636363636365,-75
Morehouse College,2015,0,27,29,1,0.0,-2
Morehouse College,2017,0,10,23,1,0.0,-13
Morehouse College,2019,0,30,35,1,0.0,-5
Morehouse College,2021,4,191,261,10,0.4,-70
Morehouse College,2022,1,108,331,10,0.1,-223
Morehouse College,2023,1,171,356,10,0.1,-185
Morgan State,2015,4,182,254,10,0.4,-72
Morgan State,2016,3,184,370,11,0.2727272727272727,-186
Morgan State,2017,1,214,405,11,0.09090909090909091,-191
Morgan State,2018,4,206,282,11,0.36363636363636365,-76
Morgan State,2019,3,225,380,12,0.25,-155
Morgan State,2021,2,154,347,11,0.18181818181818182,-193
Morgan State,2022,4,250,308,11,0.36363636363636365,-58
Morgan State,2023,4,161,214,10,0.4,-53
Mount St. Joseph,2018,0,19,48,1,0.0,-29
Mount St. Joseph,2020,5,258,165,6,0.8333333333333334,93
Mount St. Joseph,2022,10,478,293,11,0.9090909090909091,185
Mount St. Joseph,2023,9,609,258,11,0.8181818181818182,351
Muhlenberg,2022,6,345,247,10,0.6,98
Muhlenberg,2023,9,402,192,10,0.9,210
Murray State,2015,3,336,409,11,0.2727272727272727,-73
Murray State,2016,4,287,387,11,0.36363636363636365,-100
Murray State,2017,3,232,322,11,0.2727272727272727,-90
Murray State,2018,5,307,384,11,0.45454545454545453,-77
Murray State,2019,4,274,347,12,0.3333333333333333,-73
Murray State,2020,5,195,164,7,0.7142857142857143,31
Murray State,2021,6,237,278,11,0.5454545454545454,-41
Murray State,2022,2,167,405,11,0.18181818181818182,-238
Murray State,2023,2,183,383,11,0.18181818181818182,-200
Muskingum University,2020,0,22,80,2,0.0,-58
Muskingum University,2022,5,238,288,10,0.5,-50
Muskingum University,2023,4,263,353,10,0.4,-90
NC State,2015,7,432,336,13,0.5384615384615384,96
NC State,2016,7,351,296,13,0.5384615384615384,55
NC State,2017,9,419,328,13,0.6923076923076923,91
NC State,2018,9,440,324,13,0.6923076923076923,116
NC State,2019,4,265,361,12,0.3333333333333333,-96
NC State,2020,8,363,350,12,0.6666666666666666,13
NC State,2021,9,397,236,12,0.75,161
NC State,2022,8,316,249,13,0.6153846153846154,67
NC State,2023,9,341,270,13,0.6923076923076923,71
NEWBERG,2020,1,44,33,2,0.5,11
NEWBERG,2022,8,308,206,10,0.8,102
NEWBERG,2023,4,251,250,10,0.4,1
Navy,2015,11,478,284,13,0.8461538461538461,194
Navy,2016,9,531,434,14,0.6428571428571429,97
Navy,2017,7,396,342,13,0.5384615384615384,54
Navy,2018,3,325,436,13,0.23076923076923078,-111
Navy,2019,11,483,290,13,0.8461538461538461,193
Navy,2020,3,166,303,10,0.3,-137
Navy,2021,4,241,339,12,0.3333333333333333,-98
Navy,2022,4,263,292,12,0.3333333333333333,-29
Navy,2023,5,212,269,12,0.4166666666666667,-57
Nebraska,2015,6,427,362,13,0.46153846153846156,65
Nebraska,2016,9,345,311,13,0.6923076923076923,34
Nebraska,2017,4,309,437,12,0.3333333333333333,-128
Nebraska,2018,4,360,375,12,0.3333333333333333,-15
Nebraska,2019,5,336,333,12,0.4166666666666667,3
Nebraska,2020,3,185,235,8,0.375,-50
Nebraska,2021,3,335,272,12,0.25,63
Nebraska,2022,4,271,331,12,0.3333333333333333,-60
Nebraska,2023,5,216,219,12,0.4166666666666667,-3
Nebraska Wesleyan,2020,0,19,37,1,0.0,-18
Nebraska Wesleyan,2022,1,252,466,10,0.1,-214
Nebraska Wesleyan,2023,4,200,355,10,0.4,-155
Nebraska-Kearney,2021,9,381,302,12,0.75,79
Nebraska-Kearney,2022,8,361,206,11,0.7272727272727273,155
Nebraska-Kearney,2023,3,216,303,11,0.2727272727272727,-87
Nevada,2015,7,341,349,13,0.5384615384615384,-8
Nevada,2016,5,305,348,12,0.4166666666666667,-43
Nevada,2017,3,338,407,12,0.25,-69
Nevada,2018,8,404,350,13,0.6153846153846154,54
Nevada,2019,7,277,415,13,0.5384615384615384,-138
Nevada,2020,7,277,210,9,0.7777777777777778,67
Nevada,2021,8,464,345,13,0.6153846153846154,119
Nevada,2022,2,226,371,12,0.16666666666666666,-145
Nevada,2023,2,208,401,12,0.16666666666666666,-193
New Hampshire,2015,7,287,264,12,0.5833333333333334,23
New Hampshire,2016,8,371,316,13,0.6153846153846154,55
New Hampshire,2017,9,309,301,14,0.6428571428571429,8
New Hampshire,2018,4,196,251,11,0.36363636363636365,-55
New Hampshire,2019,6,222,221,11,0.5454545454545454,1
New Hampshire,2020,0,20,24,1,0.0,-4
New Hampshire,2021,3,182,326,11,0.2727272727272727,-144
New Hampshire,2022,9,386,369,13,0.6923076923076923,17
New Hampshire,2023,6,412,325,11,0.5454545454545454,87
New Haven,2018,0,31,41,1,0.0,-10
New Haven,2021,10,363,172,12,0.8333333333333334,191
New Haven,2022,8,379,179,11,0.7272727272727273,200
New Haven,2023,8,303,185,11,0.7272727272727273,118
New Mexico,2015,7,389,369,13,0.5384615384615384,20
New Mexico,2016,9,477,409,13,0.6923076923076923,68
New Mexico,2017,3,248,382,12,0.25,-134
New Mexico,2018,3,319,434,12,0.25,-115
New Mexico,2019,2,267,446,12,0.16666666666666666,-179
New Mexico,2020,2,167,228,7,0.2857142857142857,-61
New Mexico,2021,3,146,341,12,0.25,-195
New Mexico,2022,2,157,312,12,0.16666666666666666,-155
New Mexico,2023,4,327,421,12,0.3333333333333333,-94
New Mexico Highlands,2015,0,5,41,1,0.0,-36
New Mexico Highlands,2016,0,3,73,1,0.0,-70
New Mexico Highlands,2020,1,62,26,1,1.0,36
New Mexico Highlands,2021,5,335,352,11,0.45454545454545453,-17
New Mexico Highlands,2022,3,204,319,10,0.3,-115
New Mexico Highlands,2023,2,205,440,11,0.18181818181818182,-235
New Mexico State,2015,3,343,540,12,0.25,-197
New Mexico State,2016,3,298,466,12,0.25,-168
New Mexico State,2017,7,381,386,13,0.5384615384615384,-5
New Mexico State,2018,3,303,496,12,0.25,-193
New Mexico State,2019,2,260,492,12,0.16666666666666666,-232
New Mexico State,2020,1,53,72,2,0.5,-19
New Mexico State,2021,2,271,485,12,0.16666666666666666,-214
New Mexico State,2022,7,331,311,13,0.5384615384615384,20
New Mexico State,2023,10,412,342,15,0.6666666666666666,70
Newberry,2015,0,14,17,1,0.0,-3
Newberry,2017,0,14,31,1,0.0,-17
Newberry,2018,0,26,33,1,0.0,-7
Newberry,2020,5,177,94,6,0.8333333333333334,83
Newberry,2021,10,378,218,13,0.7692307692307693,160
Newberry,2022,9,343,242,11,0.8181818181818182,101
Newberry,2023,4,218,267,11,0.36363636363636365,-49
Nicholls,2015,3,188,320,10,0.3,-132
Nicholls,2016,5,333,328,11,0.45454545454545453,5
Nicholls,2017,8,339,302,12,0.6666666666666666,37
Nicholls,2018,9,420,284,13,0.6923076923076923,136
Nicholls,2019,9,391,381,14,0.6428571428571429,10
Nicholls,2020,4,341,238,7,0.5714285714285714,103
Nicholls,2021,6,367,314,11,0.5454545454545454,53
Nicholls,2022,3,203,388,11,0.2727272727272727,-185
Nicholls,2023,6,267,281,11,0.5454545454545454,-14
Nichols College,2022,4,275,372,10,0.4,-97
Nichols College,2023,3,356,432,10,0.3,-76
Norfolk State,2015,4,184,312,11,0.36363636363636365,-128
Norfolk State,2016,4,174,269,11,0.36363636363636365,-95
Norfolk State,2017,4,209,303,11,0.36363636363636365,-94
Norfolk State,2018,4,207,300,11,0.36363636363636365,-93
Norfolk State,2019,5,347,349,12,0.4166666666666667,-2
Norfolk State,2021,6,365,338,11,0.5454545454545454,27
Norfolk State,2022,2,189,444,11,0.18181818181818182,-255
Norfolk State,2023,3,264,325,11,0.2727272727272727,-61
North Alabama,2016,0,15,60,2,0.0,-45
North Alabama,2018,7,259,243,10,0.7,16
North Alabama,2019,4,288,369,11,0.36363636363636365,-81
North Alabama,2020,0,51,142,4,0.0,-91
North Alabama,2021,3,310,366,11,0.2727272727272727,-56
North Alabama,2022,1,314,457,11,0.09090909090909091,-143
North Alabama,2023,3,252,366,11,0.2727272727272727,-114
North American University,2022,0,29,287,5,0.0,-258
North American University,2023,0,3,154,2,0.0,-151
North Carolina,2015,11,570,343,14,0.7857142857142857,227
North Carolina,2016,8,420,324,13,0.6153846153846154,96
North Carolina,2017,3,312,375,12,0.25,-63
North Carolina,2018,2,301,380,11,0.18181818181818182,-79
North Carolina,2019,7,430,308,13,0.5384615384615384,122
North Carolina,2020,8,500,353,12,0.6666666666666666,147
North Carolina,2021,6,458,417,13,0.46153846153846156,41
North Carolina,2022,9,482,431,14,0.6428571428571429,51
North Carolina,2023,8,449,355,13,0.6153846153846154,94
North Carolina A&T,2015,10,371,206,12,0.8333333333333334,165
North Carolina A&T,2016,9,422,277,12,0.75,145
North Carolina A&T,2017,12,421,149,12,1.0,272
North Carolina A&T,2018,10,361,170,12,0.8333333333333334,191
North Carolina A&T,2019,9,457,249,12,0.75,208
North Carolina A&T,2021,5,251,285,11,0.45454545454545453,-34
North Carolina A&T,2022,7,315,291,11,0.6363636363636364,24
North Carolina A&T,2023,1,177,336,11,0.09090909090909091,-159
North Carolina Central,2015,8,327,233,11,0.7272727272727273,94
North Carolina Central,2016,9,347,275,12,0.75,72
North Carolina Central,2017,7,236,211,11,0.6363636363636364,25
North Carolina Central,2018,5,289,335,11,0.45454545454545453,-46
North Carolina Central,2019,4,210,328,12,0.3333333333333333,-118
North Carolina Central,2021,6,268,287,11,0.5454545454545454,-19
North Carolina Central,2022,10,463,258,12,0.8333333333333334,205
North Carolina Central,2023,9,427,345,12,0.75,82
North Carolina Wesleyan,2019,0,21,55,1,0.0,-34
North Carolina Wesleyan,2020,0,52,101,3,0.0,-49
North Carolina Wesleyan,2022,3,157,345,10,0.3,-188
North Carolina Wesleyan,2023,4,179,283,10,0.4,-104
North Central College,2019,1,41,14,1,1.0,27
North Central College,2021,0,24,57,1,0.0,-33
North Central College,2022,15,786,80,15,1.0,706
North Central College,2023,14,879,256,15,0.9333333333333333,623
North Dakota,2015,7,309,283,11,0.6363636363636364,26
North Dakota,2016,9,355,264,12,0.75,91
North Dakota,2017,3,277,381,11,0.2727272727272727,-104
North Dakota,2018,6,293,249,11,0.5454545454545454,44
North Dakota,2019,7,319,342,12,0.5833333333333334,-23
North Dakota,2020,5,209,147,7,0.7142857142857143,62
North Dakota,2021,5,269,223,11,0.45454545454545453,46
North Dakota,2022,7,364,370,12,0.5833333333333334,-6
North Dakota,2023,7,365,303,12,0.5833333333333334,62
North Dakota State,2015,13,524,230,15,0.8666666666666667,294
North Dakota State,2016,12,408,232,14,0.8571428571428571,176
North Dakota State,2017,14,581,174,15,0.9333333333333333,407
North Dakota State,2018,15,622,189,15,1.0,433
North Dakota State,2019,16,596,197,16,1.0,399
North Dakota State,2020,7,260,190,10,0.7,70
North Dakota State,2021,14,511,167,15,0.9333333333333333,344
North Dakota State,2022,12,512,297,15,0.8,215
North Dakota State,2023,11,572,299,15,0.7333333333333333,273
North Greenville,2015,0,14,41,1,0.0,-27
North Greenville,2016,0,14,38,1,0.0,-24
North Greenville,2017,0,34,38,1,0.0,-4
North Greenville,2018,0,28,31,1,0.0,-3
North Greenville,2019,0,17,20,1,0.0,-3
North Greenville,2021,5,288,306,11,0.45454545454545453,-18
North Greenville,2022,3,298,411,11,0.2727272727272727,-113
North Greenville,2023,5,217,249,10,0.5,-32
North Park,2020,0,21,114,3,0.0,-93
North Park,2022,1,141,366,10,0.1,-225
North Park,2023,5,239,268,10,0.5,-29
North Texas,2015,1,182,495,12,0.08333333333333333,-313
North Texas,2016,5,322,424,13,0.38461538461538464,-102
North Texas,2017,9,497,490,14,0.6428571428571429,7
North Texas,2018,9,450,314,13,0.6923076923076923,136
North Texas,2019,4,367,390,12,0.3333333333333333,-23
North Texas,2020,4,344,428,10,0.4,-84
North Texas,2021,6,357,357,13,0.46153846153846156,0
North Texas,2022,7,473,444,14,0.5,29
North Texas,2023,5,414,445,12,0.4166666666666667,-31
Northeastern State,2020,0,0,38,1,0.0,-38
Northeastern State,2021,2,156,512,11,0.18181818181818182,-356
Northeastern State,2022,1,151,370,11,0.09090909090909091,-219
Northeastern State,2023,1,111,463,11,0.09090909090909091,-352
Northern Arizona,2015,7,432,383,11,0.6363636363636364,49
Northern Arizona,2016,5,361,313,11,0.45454545454545453,48
Northern Arizona,2017,7,363,356,12,0.5833333333333334,7
Northern Arizona,2018,4,258,322,10,0.4,-64
Northern Arizona,2019,4,446,496,12,0.3333333333333333,-50
Northern Arizona,2020,3,117,135,5,0.6,-18
Northern Arizona,2021,5,271,330,11,0.45454545454545453,-59
Northern Arizona,2022,3,245,322,11,0.2727272727272727,-77
Northern Arizona,2023,5,303,340,11,0.45454545454545453,-37
Northern Colorado,2015,6,330,378,11,0.5454545454545454,-48
Northern Colorado,2016,5,321,371,10,0.5,-50
Northern Colorado,2017,3,278,341,10,0.3,-63
Northern Colorado,2018,2,262,391,11,0.18181818181818182,-129
Northern Colorado,2019,2,241,453,12,0.16666666666666666,-212
Northern Colorado,2021,3,164,329,11,0.2727272727272727,-165
Northern Colorado,2022,3,229,412,11,0.2727272727272727,-183
Northern Colorado,2023,0,154,367,11,0.0,-213
Northern Illinois,2015,8,436,387,14,0.5714285714285714,49
Northern Illinois,2016,5,366,364,12,0.4166666666666667,2
Northern Illinois,2017,8,376,286,13,0.6153846153846154,90
Northern Illinois,2018,8,282,317,14,0.5714285714285714,-35
Northern Illinois,2019,5,274,338,12,0.4166666666666667,-64
Northern Illinois,2020,0,149,232,6,0.0,-83
Northern Illinois,2021,9,451,472,14,0.6428571428571429,-21
Northern Illinois,2022,3,327,393,12,0.25,-66
Northern Illinois,2023,7,324,273,13,0.5384615384615384,51
Northern Iowa,2015,9,413,274,14,0.6428571428571429,139
Northern Iowa,2016,5,320,242,11,0.45454545454545453,78
Northern Iowa,2017,8,382,307,13,0.6153846153846154,75
Northern Iowa,2018,7,333,277,13,0.5384615384615384,56
Northern Iowa,2019,10,315,265,15,0.6666666666666666,50
Northern Iowa,2020,3,137,107,7,0.42857142857142855,30
Northern Iowa,2021,6,299,216,12,0.5,83
Northern Iowa,2022,6,363,283,11,0.5454545454545454,80
Northern Iowa,2023,6,288,293,11,0.5454545454545454,-5
Northern Michigan,2021,4,233,288,11,0.36363636363636365,-55
Northern Michigan,2022,4,245,317,11,0.36363636363636365,-72
Northern Michigan,2023,0,144,538,11,0.0,-394
Northern State,2021,7,415,347,11,0.6363636363636364,68
Northern State,2022,6,283,193,11,0.5454545454545454,90
Northern State,2023,5,294,307,11,0.45454545454545453,-13
Northwest Missouri St,2015,1,34,7,1,1.0,27
Northwest Missouri St,2016,1,29,3,1,1.0,26
Northwest Missouri St,2021,11,473,162,13,0.8461538461538461,311
Northwest Missouri St,2022,10,372,209,13,0.7692307692307693,163
Northwest Missouri St,2023,7,375,225,11,0.6363636363636364,150
Northwestern,2015,10,254,242,13,0.7692307692307693,12
Northwestern,2016,7,338,289,13,0.5384615384615384,49
Northwestern,2017,10,380,261,13,0.7692307692307693,119
Northwestern,2018,9,339,325,14,0.6428571428571429,14
Northwestern,2019,3,196,283,12,0.25,-87
Northwestern,2020,7,222,143,9,0.7777777777777778,79
Northwestern,2021,3,199,348,12,0.25,-149
Northwestern,2022,1,165,340,12,0.08333333333333333,-175
Northwestern,2023,8,287,293,13,0.6153846153846154,-6
Northwestern (IA),2023,1,27,24,1,1.0,3
Northwestern (MN),2020,1,40,84,2,0.5,-44
Northwestern (MN),2022,6,271,301,11,0.5454545454545454,-30
Northwestern (MN),2023,6,273,338,10,0.6,-65
Northwestern Oklahoma State,2021,1,195,469,10,0.1,-274
Northwestern Oklahoma State,2022,1,200,431,11,0.09090909090909091,-231
Northwestern Oklahoma State,2023,1,145,467,11,0.09090909090909091,-322
Northwestern State,2015,4,276,390,10,0.4,-114
Northwestern State,2016,1,249,370,11,0.09090909090909091,-121
Northwestern State,2017,4,250,346,11,0.36363636363636365,-96
Northwestern State,2018,5,312,380,11,0.45454545454545453,-68
Northwestern State,2019,3,303,452,12,0.25,-149
Northwestern State,2020,1,143,181,6,0.16666666666666666,-38
Northwestern State,2021,3,214,375,11,0.2727272727272727,-161
Northwestern State,2022,4,237,417,11,0.36363636363636365,-180
Northwestern State,2023,0,84,216,9,0.0,-132
Northwood (MI),2021,1,172,401,10,0.1,-229
Northwood (MI),2022,4,241,341,11,0.36363636363636365,-100
Northwood (MI),2023,5,249,300,11,0.45454545454545453,-51
Norwich,2022,3,166,257,10,0.3,-91
Norwich,2023,1,158,323,10,0.1,-165
Notre Dame,2015,10,445,313,13,0.7692307692307693,132
Notre Dame,2016,4,371,334,12,0.3333333333333333,37
Notre Dame,2017,10,445,279,13,0.7692307692307693,166
Notre Dame,2018,12,408,237,13,0.9230769230769231,171
Notre Dame,2019,11,478,233,13,0.8461538461538461,245
Notre Dame,2020,10,401,236,12,0.8333333333333334,165
Notre Dame,2021,11,458,256,13,0.8461538461538461,202
Notre Dame,2022,9,413,299,13,0.6923076923076923,114
Notre Dame,2023,10,509,207,13,0.7692307692307693,302
Notre Dame College,2015,0,24,35,1,0.0,-11
Notre Dame College,2020,3,150,33,3,1.0,117
Notre Dame College,2021,11,528,238,13,0.8461538461538461,290
Notre Dame College,2022,9,378,186,12,0.75,192
Notre Dame College,2023,7,319,242,11,0.6363636363636364,77
Oberlin,2022,0,127,505,10,0.0,-378
Oberlin,2023,1,103,495,10,0.1,-392
Ohio,2015,8,358,329,13,0.6153846153846154,29
Ohio,2016,8,368,317,14,0.5714285714285714,51
Ohio,2017,9,508,315,13,0.6923076923076923,193
Ohio,2018,9,521,320,13,0.6923076923076923,201
Ohio,2019,7,446,345,13,0.5384615384615384,101
Ohio,2020,2,103,50,3,0.6666666666666666,53
Ohio,2021,3,271,364,12,0.25,-93
Ohio,2022,10,445,396,14,0.7142857142857143,49
Ohio,2023,10,316,206,13,0.7692307692307693,110
Ohio Dominican,2020,4,116,88,6,0.6666666666666666,28
Ohio Dominican,2021,7,299,230,11,0.6363636363636364,69
Ohio Dominican,2022,7,280,169,10,0.7,111
Ohio Dominican,2023,4,178,218,11,0.36363636363636365,-40
Ohio Northern,2020,3,134,77,4,0.75,57
Ohio Northern,2022,3,162,240,10,0.3,-78
Ohio Northern,2023,4,227,262,10,0.4,-35
Ohio State,2015,12,464,196,13,0.9230769230769231,268
Ohio State,2016,11,512,201,13,0.8461538461538461,311
Ohio State,2017,12,576,266,14,0.8571428571428571,310
Ohio State,2018,13,593,357,14,0.9285714285714286,236
Ohio State,2019,13,656,192,14,0.9285714285714286,464
Ohio State,2020,7,328,206,8,0.875,122
Ohio State,2021,11,594,296,13,0.8461538461538461,298
Ohio State,2022,11,575,273,13,0.8461538461538461,302
Ohio State,2023,11,397,146,13,0.8461538461538461,251
Ohio Wesleyan,2020,1,110,111,3,0.3333333333333333,-1
Ohio Wesleyan,2022,6,334,185,10,0.6,149
Ohio Wesleyan,2023,5,285,234,10,0.5,51
Oklahoma,2015,11,566,286,13,0.8461538461538461,280
Oklahoma,2016,11,571,375,13,0.8461538461538461,196
Oklahoma,2017,12,632,379,14,0.8571428571428571,253
Oklahoma,2018,12,677,466,14,0.8571428571428571,211
Oklahoma,2019,12,590,382,14,0.8571428571428571,208
Oklahoma,2020,9,473,239,11,0.8181818181818182,234
Oklahoma,2021,11,508,335,13,0.8461538461538461,173
Oklahoma,2022,6,427,390,13,0.46153846153846156,37
Oklahoma,2023,10,542,305,13,0.7692307692307693,237
Oklahoma Baptist,2021,7,415,343,11,0.6363636363636364,72
Oklahoma Baptist,2022,1,246,470,11,0.09090909090909091,-224
Oklahoma Baptist,2023,6,241,309,11,0.5454545454545454,-68
Oklahoma Panhandle St,2016,1,41,75,2,0.5,-34
Oklahoma Panhandle St,2018,0,7,62,1,0.0,-55
Oklahoma Panhandle St,2019,0,0,77,1,0.0,-77
Oklahoma Panhandle St,2023,0,7,65,1,0.0,-58
Oklahoma State,2015,10,514,396,13,0.7692307692307693,118
Oklahoma State,2016,10,502,345,13,0.7692307692307693,157
Oklahoma State,2017,10,585,382,13,0.7692307692307693,203
Oklahoma State,2018,7,499,422,13,0.5384615384615384,77
Oklahoma State,2019,8,422,348,13,0.6153846153846154,74
Oklahoma State,2020,8,332,258,11,0.7272727272727273,74
Oklahoma State,2021,12,435,253,14,0.8571428571428571,182
Oklahoma State,2022,7,398,376,13,0.5384615384615384,22
Oklahoma State,2023,10,414,400,14,0.7142857142857143,14
Old Dominion,2015,5,291,429,12,0.4166666666666667,-138
Old Dominion,2016,10,456,354,13,0.7692307692307693,102
Old Dominion,2017,5,248,380,12,0.4166666666666667,-132
Old Dominion,2018,4,370,431,12,0.3333333333333333,-61
Old Dominion,2019,1,195,358,12,0.08333333333333333,-163
Old Dominion,2021,6,359,361,13,0.46153846153846156,-2
Old Dominion,2022,3,234,319,12,0.25,-85
Old Dominion,2023,6,310,353,13,0.46153846153846156,-43
Ole Miss,2015,10,531,294,13,0.7692307692307693,237
Ole Miss,2016,5,391,408,12,0.4166666666666667,-17
Ole Miss,2017,6,394,415,12,0.5,-21
Ole Miss,2018,5,407,434,12,0.4166666666666667,-27
Ole Miss,2019,4,319,318,12,0.3333333333333333,1
Ole Miss,2020,5,392,383,10,0.5,9
Ole Miss,2021,10,438,321,13,0.7692307692307693,117
Ole Miss,2022,8,435,332,13,0.6153846153846154,103
Ole Miss,2023,11,456,293,13,0.8461538461538461,163
Olivet College,2020,1,110,113,4,0.25,-3
Olivet College,2022,5,320,271,10,0.5,49
Olivet College,2023,4,236,315,10,0.4,-79
Oregon,2015,9,559,488,13,0.6923076923076923,71
Oregon,2016,4,425,497,12,0.3333333333333333,-72
Oregon,2017,7,468,377,13,0.5384615384615384,91
Oregon,2018,9,453,330,13,0.6923076923076923,123
Oregon,2019,12,495,231,14,0.8571428571428571,264
Oregon,2020,4,219,198,7,0.5714285714285714,21
Oregon,2021,10,440,378,14,0.7142857142857143,62
Oregon,2022,10,504,356,13,0.7692307692307693,148
Oregon,2023,12,619,231,14,0.8571428571428571,388
Oregon State,2015,2,228,444,12,0.16666666666666666,-216
Oregon State,2016,4,314,366,12,0.3333333333333333,-52
Oregon State,2017,1,248,516,12,0.08333333333333333,-268
Oregon State,2018,2,313,548,12,0.16666666666666666,-235
Oregon State,2019,5,374,390,12,0.4166666666666667,-16
Oregon State,2020,2,202,233,7,0.2857142857142857,-31
Oregon State,2021,7,406,335,13,0.5384615384615384,71
Oregon State,2022,10,419,260,13,0.7692307692307693,159
Oregon State,2023,8,414,298,13,0.6153846153846154,116
Otterbein,2020,1,78,88,4,0.25,-10
Otterbein,2022,2,162,373,10,0.2,-211
Otterbein,2023,0,137,383,10,0.0,-246
Ouachita Baptist,2021,9,403,221,11,0.8181818181818182,182
Ouachita Baptist,2022,11,511,248,12,0.9166666666666666,263
Ouachita Baptist,2023,9,438,222,11,0.8181818181818182,216
Pace,2021,2,170,265,10,0.2,-95
Pace,2022,6,266,204,10,0.6,62
Pace,2023,3,189,285,10,0.3,-96
Pacific (OR),2020,1,33,44,2,0.5,-11
Pacific (OR),2022,5,240,222,9,0.5555555555555556,18
Pacific (OR),2023,2,252,255,10,0.2,-3
Pacific Lutheran,2020,0,56,132,4,0.0,-76
Pacific Lutheran,2022,6,247,171,10,0.6,76
Pacific Lutheran,2023,5,299,234,10,0.5,65
Penn State,2015,7,301,284,13,0.5384615384615384,17
Penn State,2016,11,526,356,14,0.7857142857142857,170
Penn State,2017,11,534,214,13,0.8461538461538461,320
Penn State,2018,9,439,267,13,0.6923076923076923,172
Penn State,2019,11,465,208,13,0.8461538461538461,257
Penn State,2020,4,268,249,9,0.4444444444444444,19
Penn State,2021,7,325,225,13,0.5384615384615384,100
Penn State,2022,11,465,237,13,0.8461538461538461,228
Penn State,2023,10,471,175,13,0.7692307692307693,296
PennWest California,2021,9,337,138,10,0.9,199
PennWest California,2022,6,339,216,11,0.5454545454545454,123
PennWest California,2023,7,347,230,11,0.6363636363636364,117
Pennsylvania,2015,7,329,268,10,0.7,61
Pennsylvania,2016,7,277,213,10,0.7,64
Pennsylvania,2017,5,256,233,9,0.5555555555555556,23
Pennsylvania,2018,6,186,209,10,0.6,-23
Pennsylvania,2019,5,245,298,10,0.5,-53
Pennsylvania,2021,3,191,215,10,0.3,-24
Pennsylvania,2022,8,266,197,10,0.8,69
Pennsylvania,2023,6,255,210,10,0.6,45
Phoenix,2019,0,14,66,1,0.0,-52
Phoenix,2022,1,52,12,1,1.0,40
Phoenix,2023,1,49,25,1,1.0,24
Pikeville,2015,0,20,41,1,0.0,-21
Pikeville,2016,0,14,55,1,0.0,-41
Pikeville,2019,0,20,59,1,0.0,-39
Pittsburg St,2020,0,7,26,1,0.0,-19
Pittsburg St,2021,8,348,214,11,0.7272727272727273,134
Pittsburg St,2022,12,417,183,13,0.9230769230769231,234
Pittsburg St,2023,11,440,217,13,0.8461538461538461,223
Pittsburgh,2015,8,367,339,13,0.6153846153846154,28
Pittsburgh,2016,8,532,458,13,0.6153846153846154,74
Pittsburgh,2017,5,287,319,12,0.4166666666666667,-32
Pittsburgh,2018,7,359,389,14,0.5,-30
Pittsburgh,2019,8,275,292,13,0.6153846153846154,-17
Pittsburgh,2020,6,319,270,11,0.5454545454545454,49
Pittsburgh,2021,11,580,331,14,0.7857142857142857,249
Pittsburgh,2022,9,407,316,13,0.6923076923076923,91
Pittsburgh,2023,3,242,328,12,0.25,-86
Plymouth State,2022,8,283,187,10,0.8,96
Plymouth State,2023,4,228,278,10,0.4,-50
Point University,2015,0,17,56,1,0.0,-39
Point University,2016,0,3,49,1,0.0,-46
Point University,2017,0,0,66,1,0.0,-66
Point University,2018,0,7,48,1,0.0,-41
Point University,2019,0,7,123,2,0.0,-116
Point University,2021,0,9,131,2,0.0,-122
Point University,2022,0,14,34,1,0.0,-20
Point University,2023,0,10,63,1,0.0,-53
Pomona Pitzer,2022,8,378,216,11,0.7272727272727273,162
Pomona Pitzer,2023,6,210,208,10,0.6,2
Portland State,2015,9,411,268,12,0.75,143
Portland State,2016,2,322,403,10,0.2,-81
Portland State,2017,0,256,473,11,0.0,-217
Portland State,2018,4,302,398,11,0.36363636363636365,-96
Portland State,2019,5,416,360,12,0.4166666666666667,56
Portland State,2020,0,7,48,1,0.0,-41
Portland State,2021,5,303,325,11,0.45454545454545453,-22
Portland State,2022,4,282,407,11,0.36363636363636365,-125
Portland State,2023,5,372,359,11,0.45454545454545453,13
Post University,2022,0,126,424,9,0.0,-298
Post University,2023,1,148,363,9,0.1111111111111111,-215
Prairie View A&M,2015,7,348,219,8,0.875,129
Prairie View A&M,2016,7,360,343,11,0.6363636363636364,17
Prairie View A&M,2017,6,330,275,11,0.5454545454545454,55
Prairie View A&M,2018,5,368,297,11,0.45454545454545453,71
Prairie View A&M,2019,6,391,306,11,0.5454545454545454,85
Prairie View A&M,2020,2,68,65,3,0.6666666666666666,3
Prairie View A&M,2021,7,305,315,12,0.5833333333333334,-10
Prairie View A&M,2022,6,329,292,11,0.5454545454545454,37
Prairie View A&M,2023,6,234,374,12,0.5,-140
Presbyterian,2015,2,138,223,11,0.18181818181818182,-85
Presbyterian,2016,2,98,340,11,0.18181818181818182,-242
Presbyterian,2017,4,182,325,11,0.36363636363636365,-143
Presbyterian,2018,2,142,296,10,0.2,-154
Presbyterian,2019,1,151,384,11,0.09090909090909091,-233
Presbyterian,2020,4,183,163,7,0.5714285714285714,20
Presbyterian,2021,2,404,590,11,0.18181818181818182,-186
Presbyterian,2022,1,173,469,11,0.09090909090909091,-296
Presbyterian,2023,4,238,280,11,0.36363636363636365,-42
Presentation,2022,1,42,48,2,0.5,-6
Princeton,2015,5,292,237,10,0.5,55
Princeton,2016,8,346,164,10,0.8,182
Princeton,2017,5,382,265,10,0.5,117
Princeton,2018,10,470,130,10,1.0,340
Princeton,2019,8,322,181,10,0.8,141
Princeton,2021,9,334,174,10,0.9,160
Princeton,2022,8,278,135,10,0.8,143
Princeton,2023,5,190,168,10,0.5,22
Puget Sound,2020,2,66,106,4,0.5,-40
Puget Sound,2022,1,149,402,9,0.1111111111111111,-253
Puget Sound,2023,3,204,366,9,0.3333333333333333,-162
Purdue,2015,2,301,438,12,0.16666666666666666,-137
Purdue,2016,3,295,459,12,0.25,-164
Purdue,2017,7,328,267,13,0.5384615384615384,61
Purdue,2018,6,397,390,13,0.46153846153846156,7
Purdue,2019,4,310,367,12,0.3333333333333333,-57
Purdue,2020,2,163,179,6,0.3333333333333333,-16
Purdue,2021,9,378,291,13,0.6923076923076923,87
Purdue,2022,8,372,383,14,0.5714285714285714,-11
Purdue,2023,4,287,365,12,0.3333333333333333,-78
Quincy,2016,1,38,35,1,1.0,3
Quincy,2018,0,0,49,1,0.0,-49
Quincy,2020,0,8,68,2,0.0,-60
Quincy,2021,4,385,450,11,0.36363636363636365,-65
Quincy,2022,4,344,377,11,0.36363636363636365,-33
Quincy,2023,6,423,270,11,0.5454545454545454,153
Randolph-Macon,2020,5,162,61,5,1.0,101
Randolph-Macon,2022,11,511,203,12,0.9166666666666666,308
Randolph-Macon,2023,13,636,213,14,0.9285714285714286,423
Reading,2020,0,39,71,3,0.0,-32
Reading,2022,3,174,345,10,0.3,-171
Reading,2023,1,139,371,10,0.1,-232
Redlands,2022,4,259,256,10,0.4,3
Redlands,2023,5,195,163,10,0.5,32
Reinhardt University,2019,0,7,31,1,0.0,-24
Reinhardt University,2021,0,25,35,1,0.0,-10
Rensselaer,2022,7,190,82,10,0.7,108
Rensselaer,2023,7,346,150,10,0.7,196
Rhode Island,2015,1,145,329,11,0.09090909090909091,-184
Rhode Island,2016,2,185,400,11,0.18181818181818182,-215
Rhode Island,2017,3,222,300,11,0.2727272727272727,-78
Rhode Island,2018,6,333,310,11,0.5454545454545454,23
Rhode Island,2019,2,308,436,12,0.16666666666666666,-128
Rhode Island,2020,2,78,82,3,0.6666666666666666,-4
Rhode Island,2021,7,277,279,11,0.6363636363636364,-2
Rhode Island,2022,7,337,293,11,0.6363636363636364,44
Rhode Island,2023,6,318,306,11,0.5454545454545454,12
Rhodes College,2020,0,20,163,4,0.0,-143
Rhodes College,2022,5,198,169,10,0.5,29
Rhodes College,2023,6,299,226,10,0.6,73
Rice,2015,5,313,430,12,0.4166666666666667,-117
Rice,2016,3,303,448,12,0.25,-145
Rice,2017,1,195,429,12,0.08333333333333333,-234
Rice,2018,2,246,468,13,0.15384615384615385,-222
Rice,2019,3,215,311,12,0.25,-96
Rice,2020,2,117,94,5,0.4,23
Rice,2021,4,258,434,12,0.3333333333333333,-176
Rice,2022,5,328,444,13,0.38461538461538464,-116
Rice,2023,6,384,365,13,0.46153846153846156,19
Richmond,2015,10,462,344,14,0.7142857142857143,118
Richmond,2016,10,401,328,14,0.7142857142857143,73
Richmond,2017,6,340,272,11,0.5454545454545454,68
Richmond,2018,4,243,359,11,0.36363636363636365,-116
Richmond,2019,5,275,333,12,0.4166666666666667,-58
Richmond,2020,3,96,68,4,0.75,28
Richmond,2021,6,264,220,11,0.5454545454545454,44
Richmond,2022,9,407,261,13,0.6923076923076923,146
Richmond,2023,9,366,307,13,0.6923076923076923,59
Ripon,2020,0,49,105,3,0.0,-56
Ripon,2022,9,377,140,10,0.9,237
Ripon,2023,5,230,243,10,0.5,-13
Robert Morris,2015,4,154,238,11,0.36363636363636365,-84
Robert Morris,2016,2,122,266,11,0.18181818181818182,-144
Robert Morris,2017,2,112,331,11,0.18181818181818182,-219
Robert Morris,2018,2,271,478,11,0.18181818181818182,-207
Robert Morris,2019,7,267,302,12,0.5833333333333334,-35
Robert Morris,2020,0,30,98,3,0.0,-68
Robert Morris,2021,4,201,337,10,0.4,-136
Robert Morris,2022,0,109,377,11,0.0,-268
Robert Morris,2023,4,224,318,11,0.36363636363636365,-94
Rockford,2020,1,70,125,4,0.25,-55
Rockford,2022,1,223,478,10,0.1,-255
Rockford,2023,2,238,460,10,0.2,-222
Roosevelt,2023,0,7,41,1,0.0,-34
Rose-Hulman,2020,4,176,68,5,0.8,108
Rose-Hulman,2022,6,398,223,10,0.6,175
Rose-Hulman,2023,7,422,343,10,0.7,79
Rowan,2022,7,260,198,10,0.7,62
Rowan,2023,5,215,244,10,0.5,-29
Rutgers,2015,4,325,419,12,0.3333333333333333,-94
Rutgers,2016,2,188,450,12,0.16666666666666666,-262
Rutgers,2017,4,216,340,12,0.3333333333333333,-124
Rutgers,2018,1,162,377,12,0.08333333333333333,-215
Rutgers,2019,2,159,440,12,0.16666666666666666,-281
Rutgers,2020,3,240,289,9,0.3333333333333333,-49
Rutgers,2021,5,256,333,13,0.38461538461538464,-77
Rutgers,2022,4,209,351,12,0.3333333333333333,-142
Rutgers,2023,7,302,276,13,0.5384615384615384,26
SE Louisiana,2015,4,221,240,11,0.36363636363636365,-19
SE Louisiana,2016,7,319,328,11,0.6363636363636364,-9
SE Louisiana,2017,6,383,282,11,0.5454545454545454,101
SE Louisiana,2018,4,281,369,11,0.36363636363636365,-88
SE Louisiana,2019,8,476,382,13,0.6153846153846154,94
SE Louisiana,2020,4,277,255,7,0.5714285714285714,22
SE Louisiana,2021,9,586,425,13,0.6923076923076923,161
SE Louisiana,2022,9,459,338,13,0.6923076923076923,121
SE Louisiana,2023,3,278,313,11,0.2727272727272727,-35
SMU,2015,2,333,548,12,0.16666666666666666,-215
SMU,2016,5,332,435,12,0.4166666666666667,-103
SMU,2017,7,492,477,13,0.5384615384615384,15
SMU,2018,5,365,423,12,0.4166666666666667,-58
SMU,2019,10,544,434,13,0.7692307692307693,110
SMU,2020,7,386,309,10,0.7,77
SMU,2021,8,461,341,12,0.6666666666666666,120
SMU,2022,7,484,440,13,0.5384615384615384,44
SMU,2023,11,542,249,14,0.7857142857142857,293
SUNY Maritime,2018,0,10,51,1,0.0,-41
SUNY Maritime,2022,3,200,296,10,0.3,-96
SUNY Maritime,2023,5,177,279,10,0.5,-102
SUNY Morrisville,2022,7,193,118,10,0.7,75
SUNY Morrisville,2023,4,173,258,10,0.4,-85
Sacramento State,2015,2,216,368,11,0.18181818181818182,-152
Sacramento State,2016,2,237,402,10,0.2,-165
Sacramento State,2017,7,414,327,11,0.6363636363636364,87
Sacramento State,2018,2,241,354,10,0.2,-113
Sacramento State,2019,9,464,292,13,0.6923076923076923,172
Sacramento State,2021,9,364,229,12,0.75,135
Sacramento State,2022,12,558,337,13,0.9230769230769231,221
Sacramento State,2023,8,397,354,13,0.6153846153846154,43
Sacred Heart,2015,6,301,250,11,0.5454545454545454,51
Sacred Heart,2016,6,292,271,11,0.5454545454545454,21
Sacred Heart,2017,4,277,295,11,0.36363636363636365,-18
Sacred Heart,2018,7,309,243,11,0.6363636363636364,66
Sacred Heart,2019,7,295,267,12,0.5833333333333334,28
Sacred Heart,2020,2,98,65,4,0.5,33
Sacred Heart,2021,8,235,167,12,0.6666666666666666,68
Sacred Heart,2022,5,271,287,11,0.45454545454545453,-16
Sacred Heart,2023,2,147,272,11,0.18181818181818182,-125
Saginaw Valley State,2021,7,304,254,11,0.6363636363636364,50
Saginaw Valley State,2022,8,372,209,11,0.7272727272727273,163
Saginaw Valley State,2023,6,283,263,11,0.5454545454545454,20
Saint John's (MN),2022,9,425,182,11,0.8181818181818182,243
Saint John's (MN),2023,8,415,224,10,0.8,191
Saint Vincent,2020,2,119,111,4,0.5,8
Saint Vincent,2022,5,288,293,10,0.5,-5
Saint Vincent,2023,3,127,292,10,0.3,-165
Salisbury,2020,2,62,35,2,1.0,27
Salisbury,2022,9,366,197,11,0.8181818181818182,169
Salisbury,2023,6,285,237,10,0.6,48
Salve Regina,2022,6,198,230,10,0.6,-32
Salve Regina,2023,8,329,103,10,0.8,226
Sam Houston,2015,10,582,393,14,0.7142857142857143,189
Sam Houston,2016,12,644,386,13,0.9230769230769231,258
Sam Houston,2017,12,606,437,14,0.8571428571428571,169
Sam Houston,2018,6,330,309,11,0.5454545454545454,21
Sam Houston,2019,7,383,213,12,0.5833333333333334,170
Sam Houston,2020,10,375,196,10,1.0,179
Sam Houston,2021,11,492,257,12,0.9166666666666666,235
Sam Houston,2022,5,165,187,9,0.5555555555555556,-22
Sam Houston,2023,3,240,314,12,0.25,-74
Samford,2015,6,381,294,11,0.5454545454545454,87
Samford,2016,7,421,327,12,0.5833333333333334,94
Samford,2017,8,336,267,12,0.6666666666666666,69
Samford,2018,6,423,290,11,0.5454545454545454,133
Samford,2019,5,387,453,12,0.4166666666666667,-66
Samford,2020,4,282,191,7,0.5714285714285714,91
Samford,2021,4,417,434,11,0.36363636363636365,-17
Samford,2022,11,420,328,13,0.8461538461538461,92
Samford,2023,6,319,267,11,0.5454545454545454,52
San Diego,2015,9,341,198,11,0.8181818181818182,143
San Diego,2016,10,428,187,12,0.8333333333333334,241
San Diego,2017,10,473,227,13,0.7692307692307693,246
San Diego,2018,9,454,350,12,0.75,104
San Diego,2019,9,462,271,12,0.75,191
San Diego,2020,4,142,105,6,0.6666666666666666,37
San Diego,2021,7,283,277,11,0.6363636363636364,6
San Diego,2022,5,279,210,11,0.45454545454545453,69
San Diego,2023,4,253,277,11,0.36363636363636365,-24
San Diego State,2015,11,450,230,14,0.7857142857142857,220
San Diego State,2016,11,493,283,14,0.7857142857142857,210
San Diego State,2017,10,400,263,13,0.7692307692307693,137
San Diego State,2018,7,268,288,13,0.5384615384615384,-20
San Diego State,2019,10,276,165,13,0.7692307692307693,111
San Diego State,2020,4,197,142,8,0.5,55
San Diego State,2021,12,383,277,14,0.8571428571428571,106
San Diego State,2022,7,279,267,13,0.5384615384615384,12
San Diego State,2023,4,246,321,12,0.3333333333333333,-75
San José State,2015,6,363,354,13,0.46153846153846156,9
San José State,2016,4,293,416,12,0.3333333333333333,-123
San José State,2017,2,206,542,13,0.15384615384615385,-336
San José State,2018,1,255,439,12,0.08333333333333333,-184
San José State,2019,5,361,383,12,0.4166666666666667,-22
San José State,2020,7,229,159,8,0.875,70
San José State,2021,5,240,318,12,0.4166666666666667,-78
San José State,2022,7,329,264,12,0.5833333333333334,65
San José State,2023,7,414,333,13,0.5384615384615384,81
Savannah St,2015,1,154,436,10,0.1,-282
Savannah St,2016,3,143,308,10,0.3,-165
Savannah St,2017,3,214,347,11,0.2727272727272727,-133
Savannah St,2018,2,134,293,10,0.2,-159
Savannah St,2019,0,36,66,2,0.0,-30
Savannah St,2020,0,28,36,1,0.0,-8
Savannah St,2021,8,284,176,10,0.8,108
Savannah St,2022,5,197,211,9,0.5555555555555556,-14
Savannah St,2023,2,180,258,10,0.2,-78
Seton Hill,2021,5,210,211,11,0.45454545454545453,-1
Seton Hill,2022,2,143,267,11,0.18181818181818182,-124
Seton Hill,2023,6,248,295,11,0.5454545454545454,-47
Sewanee,2020,0,21,24,1,0.0,-3
Sewanee,2022,2,178,344,10,0.2,-166
Sewanee,2023,3,180,333,10,0.3,-153
Shaw,2015,0,7,61,1,0.0,-54
Shaw,2017,0,0,41,1,0.0,-41
Shaw,2018,0,10,80,2,0.0,-70
Shaw,2019,0,14,38,1,0.0,-24
Shaw,2021,6,260,144,10,0.6,116
Shaw,2022,3,181,190,9,0.3333333333333333,-9
Shaw,2023,3,161,267,10,0.3,-106
Shenandoah,2020,1,78,123,4,0.25,-45
Shenandoah,2022,8,286,153,10,0.8,133
Shenandoah,2023,5,299,259,10,0.5,40
Shepherd,2015,0,7,34,1,0.0,-27
Shepherd,2020,1,38,14,1,1.0,24
Shepherd,2021,13,656,386,15,0.8666666666666667,270
Shepherd,2022,14,583,257,15,0.9333333333333333,326
Shepherd,2023,9,378,298,12,0.75,80
Shippensburg,2021,9,363,220,11,0.8181818181818182,143
Shippensburg,2022,5,246,254,11,0.45454545454545453,-8
Shippensburg,2023,3,165,247,11,0.2727272727272727,-82
Shorter,2015,1,36,39,2,0.5,-3
Shorter,2016,0,0,66,1,0.0,-66
Shorter,2017,0,14,42,1,0.0,-28
Shorter,2018,0,23,107,2,0.0,-84
Shorter,2019,0,10,48,1,0.0,-38
Shorter,2020,2,97,89,4,0.5,8
Shorter,2021,3,166,305,10,0.3,-139
Shorter,2022,3,273,363,11,0.2727272727272727,-90
Shorter,2023,3,230,375,11,0.2727272727272727,-145
Simon Fraser,2019,0,7,70,1,0.0,-63
Simon Fraser,2021,1,84,350,8,0.125,-266
Simon Fraser,2022,1,126,333,9,0.1111111111111111,-207
Simpson College (IA),2020,0,14,49,1,0.0,-35
Simpson College (IA),2022,1,203,442,9,0.1111111111111111,-239
Simpson College (IA),2023,3,250,445,10,0.3,-195
Sioux Falls,2021,7,308,213,10,0.7,95
Sioux Falls,2022,8,361,228,11,0.7272727272727273,133
Sioux Falls,2023,3,278,396,11,0.2727272727272727,-118
Slippery Rock,2021,9,467,248,12,0.75,219
Slippery Rock,2022,10,401,210,13,0.7692307692307693,191
Slippery Rock,2023,12,573,313,14,0.8571428571428571,260
South Alabama,2015,5,300,447,12,0.4166666666666667,-147
South Alabama,2016,6,330,351,13,0.46153846153846156,-21
South Alabama,2017,4,238,318,12,0.3333333333333333,-80
South Alabama,2018,3,290,465,12,0.25,-175
South Alabama,2019,2,221,368,12,0.16666666666666666,-147
South Alabama,2020,4,219,300,11,0.36363636363636365,-81
South Alabama,2021,5,299,317,12,0.4166666666666667,-18
South Alabama,2022,10,406,277,13,0.7692307692307693,129
South Alabama,2023,7,430,273,13,0.5384615384615384,157
South Carolina,2015,3,263,330,12,0.25,-67
South Carolina,2016,6,270,344,13,0.46153846153846156,-74
South Carolina,2017,9,315,269,13,0.6923076923076923,46
South Carolina,2018,7,391,354,13,0.5384615384615384,37
South Carolina,2019,4,269,313,12,0.3333333333333333,-44
South Carolina,2020,2,235,360,10,0.2,-125
South Carolina,2021,7,294,312,13,0.5384615384615384,-18
South Carolina,2022,8,418,375,13,0.6153846153846154,43
South Carolina,2023,5,312,316,12,0.4166666666666667,-4
South Carolina State,2015,7,294,167,11,0.6363636363636364,127
South Carolina State,2016,5,232,254,11,0.45454545454545453,-22
South Carolina State,2017,3,205,188,10,0.3,17
South Carolina State,2018,5,215,268,11,0.45454545454545453,-53
South Carolina State,2019,8,331,223,11,0.7272727272727273,108
South Carolina State,2020,3,69,75,4,0.75,-6
South Carolina State,2021,7,299,314,12,0.5833333333333334,-15
South Carolina State,2022,3,246,338,11,0.2727272727272727,-92
South Carolina State,2023,5,268,283,11,0.45454545454545453,-15
South Dakota,2015,5,231,280,11,0.45454545454545453,-49
South Dakota,2016,4,329,379,11,0.36363636363636365,-50
South Dakota,2017,8,496,344,13,0.6153846153846154,152
South Dakota,2018,4,294,376,11,0.36363636363636365,-82
South Dakota,2019,5,363,389,12,0.4166666666666667,-26
South Dakota,2020,1,71,96,4,0.25,-25
South Dakota,2021,7,324,248,12,0.5833333333333334,76
South Dakota,2022,3,179,321,11,0.2727272727272727,-142
South Dakota,2023,10,312,230,13,0.7692307692307693,82
South Dakota Mines,2021,6,308,293,11,0.5454545454545454,15
South Dakota Mines,2022,7,346,265,11,0.6363636363636364,81
South Dakota Mines,2023,5,376,270,11,0.45454545454545453,106
South Dakota State,2015,8,341,208,12,0.6666666666666666,133
South Dakota State,2016,9,431,355,13,0.6923076923076923,76
South Dakota State,2017,11,521,335,14,0.7857142857142857,186
South Dakota State,2018,10,553,290,13,0.7692307692307693,263
South Dakota State,2019,8,386,217,13,0.6153846153846154,169
South Dakota State,2020,8,292,150,10,0.8,142
South Dakota State,2021,11,542,296,15,0.7333333333333333,246
South Dakota State,2022,14,512,237,15,0.9333333333333333,275
South Dakota State,2023,15,550,139,15,1.0,411
South Florida,2015,8,437,298,13,0.6153846153846154,139
South Florida,2016,11,569,411,13,0.8461538461538461,158
South Florida,2017,10,459,282,12,0.8333333333333334,177
South Florida,2018,7,370,416,13,0.5384615384615384,-46
South Florida,2019,4,250,347,12,0.3333333333333333,-97
South Florida,2020,1,208,359,9,0.1111111111111111,-151
South Florida,2021,2,278,416,12,0.16666666666666666,-138
South Florida,2022,1,336,494,12,0.08333333333333333,-158
South Florida,2023,7,415,419,13,0.5384615384615384,-4
Southeast Missouri State,2015,4,279,299,11,0.36363636363636365,-20
Southeast Missouri State,2016,3,229,268,11,0.2727272727272727,-39
Southeast Missouri State,2017,3,225,240,11,0.2727272727272727,-15
Southeast Missouri State,2018,9,482,403,13,0.6923076923076923,79
Southeast Missouri State,2019,9,358,324,13,0.6923076923076923,34
Southeast Missouri State,2020,4,221,181,8,0.5,40
Southeast Missouri State,2021,4,297,341,11,0.36363636363636365,-44
Southeast Missouri State,2022,9,427,271,12,0.75,156
Southeast Missouri State,2023,4,294,326,11,0.36363636363636365,-32
Southeastern Oklahoma State,2021,8,377,258,11,0.7272727272727273,119
Southeastern Oklahoma State,2022,6,386,340,11,0.5454545454545454,46
Southeastern Oklahoma State,2023,5,203,280,11,0.45454545454545453,-77
Southern,2015,6,339,322,10,0.6,17
Southern,2016,8,438,311,11,0.7272727272727273,127
Southern,2017,7,301,305,11,0.6363636363636364,-4
Southern,2018,7,311,277,11,0.6363636363636364,34
Southern,2019,8,427,338,13,0.6153846153846154,89
Southern,2020,5,190,98,6,0.8333333333333334,92
Southern,2021,4,290,339,11,0.36363636363636365,-49
Southern,2022,7,380,261,12,0.5833333333333334,119
Southern,2023,6,255,223,11,0.5454545454545454,32
Southern Arkansas,2021,4,319,395,11,0.36363636363636365,-76
Southern Arkansas,2022,5,377,357,11,0.45454545454545453,20
Southern Arkansas,2023,9,420,265,11,0.8181818181818182,155
Southern Connecticut State,2021,4,200,295,10,0.4,-95
Southern Connecticut State,2022,3,199,338,11,0.2727272727272727,-139
Southern Connecticut State,2023,4,189,214,10,0.4,-25
Southern Illinois,2015,3,397,381,11,0.2727272727272727,16
Southern Illinois,2016,4,340,338,11,0.36363636363636365,2
Southern Illinois,2017,4,301,302,11,0.36363636363636365,-1
Southern Illinois,2018,2,331,448,11,0.18181818181818182,-117
Southern Illinois,2019,7,339,276,12,0.5833333333333334,63
Southern Illinois,2020,6,271,297,10,0.6,-26
Southern Illinois,2021,8,402,336,13,0.6153846153846154,66
Southern Illinois,2022,5,311,294,11,0.45454545454545453,17
Southern Illinois,2023,8,332,210,13,0.6153846153846154,122
Southern Miss,2015,9,559,358,14,0.6428571428571429,201
Southern Miss,2016,7,427,384,13,0.5384615384615384,43
Southern Miss,2017,8,379,318,13,0.6153846153846154,61
Southern Miss,2018,6,288,218,11,0.5454545454545454,70
Southern Miss,2019,7,346,341,13,0.5384615384615384,5
Southern Miss,2020,3,253,323,10,0.3,-70
Southern Miss,2021,3,212,335,12,0.25,-123
Southern Miss,2022,7,329,306,13,0.5384615384615384,23
Southern Miss,2023,3,278,429,12,0.25,-151
Southern Nazarene,2021,1,157,371,10,0.1,-214
Southern Nazarene,2022,5,373,433,11,0.45454545454545453,-60
Southern Nazarene,2023,6,354,307,11,0.5454545454545454,47
Southern Oregon,2016,0,35,52,1,0.0,-17
Southern Oregon,2019,0,19,77,1,0.0,-58
Southern Oregon,2023,1,49,7,1,1.0,42
Southern Utah,2015,8,425,250,12,0.6666666666666666,175
Southern Utah,2016,6,321,312,11,0.5454545454545454,9
Southern Utah,2017,9,403,336,12,0.75,67
Southern Utah,2018,1,281,456,11,0.09090909090909091,-175
Southern Utah,2019,3,295,451,12,0.25,-156
Southern Utah,2020,1,159,164,6,0.16666666666666666,-5
Southern Utah,2021,1,209,432,11,0.09090909090909091,-223
Southern Utah,2022,5,331,307,11,0.45454545454545453,24
Southern Utah,2023,6,350,261,11,0.5454545454545454,89
Southern Virginia,2020,0,42,101,3,0.0,-59
Southern Virginia,2022,1,196,394,10,0.1,-198
Southern Virginia,2023,1,151,423,10,0.1,-272
Southwest Baptist,2018,0,7,49,1,0.0,-42
Southwest Baptist,2020,1,109,136,3,0.3333333333333333,-27
Southwest Baptist,2021,4,345,443,11,0.36363636363636365,-98
Southwest Baptist,2022,6,344,335,11,0.5454545454545454,9
Southwest Baptist,2023,4,301,355,11,0.36363636363636365,-54
Southwest Minnesota State,2021,2,162,400,11,0.18181818181818182,-238
Southwest Minnesota State,2022,4,214,318,11,0.36363636363636365,-104
Southwest Minnesota State,2023,2,175,323,11,0.18181818181818182,-148
Southwestern Assemblies Of God,2023,0,10,42,1,0.0,-32
Southwestern College,2016,0,0,57,1,0.0,-57
Southwestern College,2017,0,14,55,1,0.0,-41
Southwestern Oklahoma State,2021,0,226,364,11,0.0,-138
Southwestern Oklahoma State,2022,4,341,403,11,0.36363636363636365,-62
Southwestern Oklahoma State,2023,0,98,424,11,0.0,-326
Southwestern University,2020,0,78,160,5,0.0,-82
Southwestern University,2022,2,206,417,10,0.2,-211
Southwestern University,2023,3,234,349,10,0.3,-115
Springfield,2022,9,410,206,12,0.75,204
Springfield,2023,9,391,171,11,0.8181818181818182,220
St Ambrose University  Iowa,2023,0,33,80,2,0.0,-47
St Francis Illinois,2018,0,7,55,1,0.0,-48
St John Fisher University,2022,4,188,228,10,0.4,-40
St John Fisher University,2023,5,248,232,10,0.5,16
St. Anselm,2015,0,19,43,1,0.0,-24
St. Anselm,2016,0,16,38,1,0.0,-22
St. Anselm,2017,0,7,37,1,0.0,-30
St. Anselm,2021,3,226,293,9,0.3333333333333333,-67
St. Anselm,2022,6,226,168,10,0.6,58
St. Anselm,2023,6,174,182,10,0.6,-8
St. Augustine's,2015,0,0,72,1,0.0,-72
St. Augustine's,2016,0,7,127,2,0.0,-120
St. Augustine's,2018,0,28,114,2,0.0,-86
St. Augustine's,2021,1,88,303,8,0.125,-215
St. Augustine's,2022,1,103,422,9,0.1111111111111111,-319
St. Augustine's,2023,0,84,270,10,0.0,-186
St. Francis (PA),2015,6,282,209,10,0.6,73
St. Francis (PA),2016,7,323,238,12,0.5833333333333334,85
St. Francis (PA),2017,5,241,161,11,0.45454545454545453,80
St. Francis (PA),2018,4,288,222,11,0.36363636363636365,66
St. Francis (PA),2019,6,302,261,12,0.5,41
St. Francis (PA),2021,5,252,210,11,0.45454545454545453,42
St. Francis (PA),2022,9,431,258,12,0.75,173
St. Francis (PA),2023,4,272,264,10,0.4,8
St. Lawrence,2022,4,168,232,10,0.4,-64
St. Lawrence,2023,3,141,281,10,0.3,-140
St. Norbert,2022,7,252,128,10,0.7,124
St. Norbert,2023,7,289,169,10,0.7,120
St. Olaf,2022,4,251,329,9,0.4444444444444444,-78
St. Olaf,2023,5,345,296,10,0.5,49
St. Scholastica,2022,2,215,432,9,0.2222222222222222,-217
St. Scholastica,2023,2,217,399,10,0.2,-182
St. Thomas (MN),2015,0,35,49,1,0.0,-14
St. Thomas (MN),2021,7,250,178,10,0.7,72
St. Thomas (MN),2022,10,358,189,11,0.9090909090909091,169
St. Thomas (MN),2023,8,265,243,11,0.7272727272727273,22
St. Thomas University (Fl),2022,0,26,31,1,0.0,-5
St. Thomas University (Fl),2023,0,33,34,1,0.0,-1
St. Xavier IL,2018,0,0,46,1,0.0,-46
St. Xavier IL,2021,0,10,34,1,0.0,-24
St. Xavier IL,2022,0,0,57,1,0.0,-57
St. Xavier IL,2023,0,10,32,1,0.0,-22
Stanford,2015,12,529,316,14,0.8571428571428571,213
Stanford,2016,10,342,265,13,0.7692307692307693,77
Stanford,2017,9,453,318,14,0.6428571428571429,135
Stanford,2018,9,369,298,13,0.6923076923076923,71
Stanford,2019,4,260,358,12,0.3333333333333333,-98
Stanford,2020,4,176,190,6,0.6666666666666666,-14
Stanford,2021,3,245,389,12,0.25,-144
Stanford,2022,3,256,386,12,0.25,-130
Stanford,2023,3,247,452,12,0.25,-205
Stephen F. Austin,2015,4,288,328,10,0.4,-40
Stephen F. Austin,2016,5,334,422,11,0.45454545454545453,-88
Stephen F. Austin,2017,4,216,325,11,0.36363636363636365,-109
Stephen F. Austin,2018,2,181,333,10,0.2,-152
Stephen F. Austin,2019,3,289,419,12,0.25,-130
Stephen F. Austin,2020,6,259,224,10,0.6,35
Stephen F. Austin,2021,8,411,232,12,0.6666666666666666,179
Stephen F. Austin,2022,6,377,340,11,0.5454545454545454,37
Stephen F. Austin,2023,3,322,349,11,0.2727272727272727,-27
Stetson,2015,3,237,346,11,0.2727272727272727,-109
Stetson,2016,4,233,303,11,0.36363636363636365,-70
Stetson,2017,2,166,337,11,0.18181818181818182,-171
Stetson,2018,8,373,296,10,0.8,77
Stetson,2019,7,352,288,11,0.6363636363636364,64
Stetson,2020,0,47,117,4,0.0,-70
Stetson,2021,4,262,332,11,0.36363636363636365,-70
Stetson,2022,4,279,285,11,0.36363636363636365,-6
Stetson,2023,3,256,406,11,0.2727272727272727,-150
Stevenson,2020,1,28,10,1,1.0,18
Stevenson,2022,8,260,144,10,0.8,116
Stevenson,2023,7,292,177,10,0.7,115
Stonehill,2021,8,301,169,10,0.8,132
Stonehill,2022,4,275,207,9,0.4444444444444444,68
Stonehill,2023,5,229,303,10,0.5,-74
Stony Brook,2015,5,173,157,10,0.5,16
Stony Brook,2016,5,184,222,11,0.45454545454545453,-38
Stony Brook,2017,10,380,268,13,0.7692307692307693,112
Stony Brook,2018,7,322,244,12,0.5833333333333334,78
Stony Brook,2019,5,292,328,12,0.4166666666666667,-36
Stony Brook,2020,1,56,89,4,0.25,-33
Stony Brook,2021,5,233,252,11,0.45454545454545453,-19
Stony Brook,2022,2,166,355,11,0.18181818181818182,-189
Stony Brook,2023,0,152,392,10,0.0,-240
Sul Ross State,2020,1,82,168,5,0.2,-86
Sul Ross State,2022,4,286,374,10,0.4,-88
Sul Ross State,2023,4,253,336,10,0.4,-83
Susquehanna,2022,10,412,154,11,0.9090909090909091,258
Susquehanna,2023,10,432,150,11,0.9090909090909091,282
Syracuse,2015,4,327,372,12,0.3333333333333333,-45
Syracuse,2016,4,308,463,12,0.3333333333333333,-155
Syracuse,2017,4,329,386,12,0.3333333333333333,-57
Syracuse,2018,10,523,351,13,0.7692307692307693,172
Syracuse,2019,5,339,368,12,0.4166666666666667,-29
Syracuse,2020,1,196,360,11,0.09090909090909091,-164
Syracuse,2021,5,299,316,12,0.4166666666666667,-17
Syracuse,2022,7,360,300,13,0.5384615384615384,60
Syracuse,2023,6,306,330,13,0.46153846153846156,-24
TCU,2015,11,547,354,13,0.8461538461538461,193
TCU,2016,6,403,364,13,0.46153846153846156,39
TCU,2017,11,470,266,14,0.7857142857142857,204
TCU,2018,7,306,300,13,0.5384615384615384,6
TCU,2019,5,364,317,12,0.4166666666666667,47
TCU,2020,6,308,242,10,0.6,66
TCU,2021,5,344,419,12,0.4166666666666667,-75
TCU,2022,13,582,435,15,0.8666666666666667,147
TCU,2023,5,376,334,12,0.4166666666666667,42
Tarleton State,2016,0,3,33,1,0.0,-30
Tarleton State,2019,1,37,26,1,1.0,11
Tarleton State,2020,5,255,154,8,0.625,101
Tarleton State,2021,6,296,240,11,0.5454545454545454,56
Tarleton State,2022,6,341,306,11,0.5454545454545454,35
Tarleton State,2023,8,366,270,11,0.7272727272727273,96
Taylor,2016,0,14,27,1,0.0,-13
Taylor,2017,0,21,27,1,0.0,-6
Taylor,2018,0,17,31,1,0.0,-14
Taylor,2019,1,17,14,1,1.0,3
Taylor,2021,0,24,77,1,0.0,-53
Taylor,2022,0,10,45,1,0.0,-35
Taylor,2023,0,33,93,2,0.0,-60
Temple,2015,10,417,281,14,0.7142857142857143,136
Temple,2016,10,453,258,14,0.7142857142857143,195
Temple,2017,7,326,335,13,0.5384615384615384,-9
Temple,2018,8,454,352,13,0.6153846153846154,102
Temple,2019,8,342,337,13,0.6153846153846154,5
Temple,2020,1,139,260,7,0.14285714285714285,-121
Temple,2021,3,196,450,12,0.25,-254
Temple,2022,3,263,351,12,0.25,-88
Temple,2023,3,253,428,12,0.25,-175
Tennessee,2015,9,457,260,13,0.6923076923076923,197
Tennessee,2016,9,473,375,13,0.6923076923076923,98
Tennessee,2017,4,238,349,12,0.3333333333333333,-111
Tennessee,2018,5,273,335,12,0.4166666666666667,-62
Tennessee,2019,8,314,282,13,0.6153846153846154,32
Tennessee,2020,3,215,301,10,0.3,-86
Tennessee,2021,7,511,378,13,0.5384615384615384,133
Tennessee,2022,11,599,296,13,0.8461538461538461,303
Tennessee,2023,9,413,264,13,0.6923076923076923,149
Tennessee State,2015,4,246,281,10,0.4,-35
Tennessee State,2016,7,355,331,11,0.6363636363636364,24
Tennessee State,2017,6,267,216,11,0.5454545454545454,51
Tennessee State,2018,4,264,289,9,0.4444444444444444,-25
Tennessee State,2019,3,314,415,12,0.25,-101
Tennessee State,2020,2,129,214,7,0.2857142857142857,-85
Tennessee State,2021,5,217,296,11,0.45454545454545453,-79
Tennessee State,2022,4,201,272,11,0.36363636363636365,-71
Tennessee State,2023,6,250,265,11,0.5454545454545454,-15
Tennessee Tech,2015,4,254,395,11,0.36363636363636365,-141
Tennessee Tech,2016,5,296,316,11,0.45454545454545453,-20
Tennessee Tech,2017,1,174,325,11,0.09090909090909091,-151
Tennessee Tech,2018,1,198,507,11,0.09090909090909091,-309
Tennessee Tech,2019,6,348,422,12,0.5,-74
Tennessee Tech,2020,2,140,186,7,0.2857142857142857,-46
Tennessee Tech,2021,3,202,350,11,0.2727272727272727,-148
Tennessee Tech,2022,4,266,356,11,0.36363636363636365,-90
Tennessee Tech,2023,4,182,278,11,0.36363636363636365,-96
Texas,2015,5,317,364,12,0.4166666666666667,-47
Texas,2016,5,383,378,12,0.4166666666666667,5
Texas,2017,7,383,276,13,0.5384615384615384,107
Texas,2018,10,435,362,14,0.7142857142857143,73
Texas,2019,8,458,357,13,0.6153846153846154,101
Texas,2020,7,427,285,10,0.7,142
Texas,2021,5,423,373,12,0.4166666666666667,50
Texas,2022,8,448,281,13,0.6153846153846154,167
Texas,2023,12,501,265,14,0.8571428571428571,236
Texas A&M,2015,8,361,286,13,0.6153846153846154,75
Texas A&M,2016,8,453,319,13,0.6153846153846154,134
Texas A&M,2017,7,425,399,13,0.5384615384615384,26
Texas A&M,2018,9,468,329,13,0.6923076923076923,139
Texas A&M,2019,8,384,293,13,0.6153846153846154,91
Texas A&M,2020,9,326,217,10,0.9,109
Texas A&M,2021,8,352,191,12,0.6666666666666666,161
Texas A&M,2022,5,273,254,12,0.4166666666666667,19
Texas A&M,2023,7,433,287,13,0.5384615384615384,146
Texas A&M-Kingsville,2015,0,16,18,1,0.0,-2
Texas A&M-Kingsville,2016,1,31,22,1,1.0,9
Texas A&M-Kingsville,2021,5,242,253,10,0.5,-11
Texas A&M-Kingsville,2022,7,338,228,11,0.6363636363636364,110
Texas A&M-Kingsville,2023,7,254,207,10,0.7,47
Texas College,2021,0,0,144,2,0.0,-144
Texas College,2023,0,2,166,2,0.0,-164
Texas Lutheran,2020,3,148,146,5,0.6,2
Texas Lutheran,2022,4,260,326,10,0.4,-66
Texas Lutheran,2023,2,256,294,10,0.2,-38
Texas Southern,2015,2,177,283,8,0.25,-106
Texas Southern,2016,4,256,304,11,0.36363636363636365,-48
Texas Southern,2017,2,182,322,11,0.18181818181818182,-140
Texas Southern,2018,1,185,349,10,0.1,-164
Texas Southern,2019,0,241,500,11,0.0,-259
Texas Southern,2020,1,44,71,3,0.3333333333333333,-27
Texas Southern,2021,2,290,397,10,0.2,-107
Texas Southern,2022,5,281,285,11,0.45454545454545453,-4
Texas Southern,2023,3,288,360,11,0.2727272727272727,-72
Texas State,2015,3,323,470,12,0.25,-147
Texas State,2016,2,223,493,12,0.16666666666666666,-270
Texas State,2017,2,207,403,12,0.16666666666666666,-196
Texas State,2018,3,237,331,12,0.25,-94
Texas State,2019,3,221,391,12,0.25,-170
Texas State,2020,2,332,458,12,0.16666666666666666,-126
Texas State,2021,4,277,396,12,0.3333333333333333,-119
Texas State,2022,4,253,316,12,0.3333333333333333,-63
Texas State,2023,8,477,427,13,0.6153846153846154,50
Texas Tech,2015,7,586,567,13,0.5384615384615384,19
Texas Tech,2016,5,524,522,12,0.4166666666666667,2
Texas Tech,2017,6,446,419,13,0.46153846153846156,27
Texas Tech,2018,5,448,373,12,0.4166666666666667,75
Texas Tech,2019,4,366,364,12,0.3333333333333333,2
Texas Tech,2020,4,291,367,10,0.4,-76
Texas Tech,2021,7,394,392,13,0.5384615384615384,2
Texas Tech,2022,8,445,379,13,0.6153846153846154,66
Texas Tech,2023,7,356,338,13,0.5384615384615384,18
Texas Wesleyan,2019,0,13,58,1,0.0,-45
Texas Wesleyan,2021,0,3,63,1,0.0,-60
The Citadel,2015,9,400,283,13,0.6923076923076923,117
The Citadel,2016,10,317,246,12,0.8333333333333334,71
The Citadel,2017,5,237,290,11,0.45454545454545453,-53
The Citadel,2018,5,328,333,11,0.45454545454545453,-5
The Citadel,2019,6,346,338,12,0.5,8
The Citadel,2020,2,194,360,12,0.16666666666666666,-166
The Citadel,2021,4,271,378,11,0.36363636363636365,-107
The Citadel,2022,4,206,276,11,0.36363636363636365,-70
The Citadel,2023,0,110,384,11,0.0,-274
Thiel,2022,1,101,397,10,0.1,-296
Thiel,2023,3,122,311,10,0.3,-189
Thomas More College,2022,0,14,34,1,0.0,-20
Thomas More College,2023,5,270,264,11,0.45454545454545453,6
Tiffin,2020,5,124,45,5,1.0,79
Tiffin,2021,8,357,224,11,0.7272727272727273,133
Tiffin,2022,6,365,156,10,0.6,209
Tiffin,2023,11,524,195,12,0.9166666666666666,329
Toledo,2015,10,420,249,12,0.8333333333333334,171
Toledo,2016,9,494,334,13,0.6923076923076923,160
Toledo,2017,11,509,367,14,0.7857142857142857,142
Toledo,2018,7,525,397,13,0.5384615384615384,128
Toledo,2019,6,327,386,12,0.5,-59
Toledo,2020,4,210,146,6,0.6666666666666666,64
Toledo,2021,7,434,283,13,0.5384615384615384,151
Toledo,2022,9,438,351,14,0.6428571428571429,87
Toledo,2023,11,452,284,14,0.7857142857142857,168
Towson,2015,7,260,236,11,0.6363636363636364,24
Towson,2016,4,243,304,11,0.36363636363636365,-61
Towson,2017,5,192,263,11,0.45454545454545453,-71
Towson,2018,7,414,346,12,0.5833333333333334,68
Towson,2019,7,363,282,12,0.5833333333333334,81
Towson,2021,4,215,315,11,0.36363636363636365,-100
Towson,2022,6,235,306,11,0.5454545454545454,-71
Towson,2023,5,264,356,11,0.45454545454545453,-92
Trine University,2020,2,85,71,3,0.6666666666666666,14
Trine University,2022,7,303,209,10,0.7,94
Trine University,2023,6,358,304,10,0.6,54
Trinity (CT),2022,9,301,98,9,1.0,203
Trinity (CT),2023,8,399,115,9,0.8888888888888888,284
Trinity International (IL),2016,0,24,49,1,0.0,-25
Trinity International (IL),2017,0,10,44,1,0.0,-34
Trinity International (IL),2022,0,14,53,1,0.0,-39
Trinity University TX,2020,3,113,59,4,0.75,54
Trinity University TX,2022,11,404,137,12,0.9166666666666666,267
Trinity University TX,2023,10,512,204,12,0.8333333333333334,308
Troy,2015,4,335,339,12,0.3333333333333333,-4
Troy,2016,10,438,287,13,0.7692307692307693,151
Troy,2017,11,410,240,13,0.8461538461538461,170
Troy,2018,10,399,286,13,0.7692307692307693,113
Troy,2019,5,406,417,12,0.4166666666666667,-11
Troy,2020,5,301,283,11,0.45454545454545453,18
Troy,2021,5,274,313,12,0.4166666666666667,-39
Troy,2022,12,358,240,14,0.8571428571428571,118
Troy,2023,11,415,240,14,0.7857142857142857,175
Truman State,2018,1,34,20,1,1.0,14
Truman State,2019,2,48,14,2,1.0,34
Truman State,2020,3,118,62,3,1.0,56
Truman State,2021,8,369,215,11,0.7272727272727273,154
Truman State,2022,8,313,178,10,0.8,135
Truman State,2023,9,302,188,11,0.8181818181818182,114
Tufts,2022,6,312,174,9,0.6666666666666666,138
Tufts,2023,6,280,163,9,0.6666666666666666,117
Tulane,2015,3,236,435,12,0.25,-199
Tulane,2016,4,289,332,12,0.3333333333333333,-43
Tulane,2017,5,330,350,12,0.4166666666666667,-20
Tulane,2018,7,349,358,13,0.5384615384615384,-9
Tulane,2019,7,430,342,13,0.5384615384615384,88
Tulane,2020,6,416,337,12,0.5,79
Tulane,2021,2,331,408,12,0.16666666666666666,-77
Tulane,2022,12,504,311,14,0.8571428571428571,193
Tulane,2023,11,369,287,14,0.7857142857142857,82
Tulsa,2015,6,483,518,13,0.46153846153846156,-35
Tulsa,2016,10,552,388,13,0.7692307692307693,164
Tulsa,2017,2,352,450,12,0.16666666666666666,-98
Tulsa,2018,3,289,355,12,0.25,-66
Tulsa,2019,4,317,376,12,0.3333333333333333,-59
Tulsa,2020,6,244,194,9,0.6666666666666666,50
Tulsa,2021,7,343,346,13,0.5384615384615384,-3
Tulsa,2022,5,367,397,12,0.4166666666666667,-30
Tulsa,2023,4,281,406,12,0.3333333333333333,-125
Tuskegee,2016,1,20,17,1,1.0,3
Tuskegee,2017,2,47,13,2,1.0,34
Tuskegee,2019,0,31,38,1,0.0,-7
Tuskegee,2021,3,214,303,11,0.2727272727272727,-89
Tuskegee,2022,8,299,310,11,0.7272727272727273,-11
Tuskegee,2023,7,257,304,11,0.6363636363636364,-47
UAB,2017,8,361,333,13,0.6153846153846154,28
UAB,2018,11,418,238,14,0.7857142857142857,180
UAB,2019,9,324,302,14,0.6428571428571429,22
UAB,2020,6,256,193,9,0.6666666666666666,63
UAB,2021,9,384,302,13,0.6923076923076923,82
UAB,2022,7,391,301,13,0.5384615384615384,90
UAB,2023,4,359,443,12,0.3333333333333333,-84
UAlbany,2015,3,165,315,11,0.2727272727272727,-150
UAlbany,2016,7,274,207,11,0.6363636363636364,67
UAlbany,2017,4,191,195,11,0.36363636363636365,-4
UAlbany,2018,3,232,337,11,0.2727272727272727,-105
UAlbany,2019,9,439,357,14,0.6428571428571429,82
UAlbany,2020,1,75,96,4,0.25,-21
UAlbany,2021,2,208,288,11,0.18181818181818182,-80
UAlbany,2022,3,326,375,11,0.2727272727272727,-49
UAlbany,2023,11,426,297,15,0.7333333333333333,129
UC Davis,2015,2,245,376,11,0.18181818181818182,-131
UC Davis,2016,3,310,408,11,0.2727272727272727,-98
UC Davis,2017,5,370,354,11,0.45454545454545453,16
UC Davis,2018,10,516,356,13,0.7692307692307693,160
UC Davis,2019,5,344,352,12,0.4166666666666667,-8
UC Davis,2020,3,166,118,5,0.6,48
UC Davis,2021,8,340,273,12,0.6666666666666666,67
UC Davis,2022,6,395,239,11,0.5454545454545454,156
UC Davis,2023,7,283,269,11,0.6363636363636364,14
UCF,2015,0,167,452,12,0.0,-285
UCF,2016,6,374,320,13,0.46153846153846156,54
UCF,2017,13,627,329,13,1.0,298
UCF,2018,12,562,295,13,0.9230769230769231,267
UCF,2019,10,564,299,13,0.7692307692307693,265
UCF,2020,6,422,332,10,0.6,90
UCF,2021,9,415,319,13,0.6923076923076923,96
UCF,2022,9,460,331,14,0.6428571428571429,129
UCF,2023,6,407,335,13,0.46153846153846156,72
UCLA,2015,8,419,338,13,0.6153846153846154,81
UCLA,2016,4,299,330,12,0.3333333333333333,-31
UCLA,2017,6,422,476,13,0.46153846153846156,-54
UCLA,2018,3,288,409,12,0.25,-121
UCLA,2019,4,320,417,12,0.3333333333333333,-97
UCLA,2020,3,248,215,7,0.42857142857142855,33
UCLA,2021,8,438,321,12,0.6666666666666666,117
UCLA,2022,9,510,377,13,0.6923076923076923,133
UCLA,2023,8,344,239,13,0.6153846153846154,105
UConn,2015,6,223,253,13,0.46153846153846156,-30
UConn,2016,3,178,337,12,0.25,-159
UConn,2017,3,283,455,12,0.25,-172
UConn,2018,1,266,605,12,0.08333333333333333,-339
UConn,2019,2,227,486,12,0.16666666666666666,-259
UConn,2021,1,187,462,12,0.08333333333333333,-275
UConn,2022,6,252,341,13,0.46153846153846156,-89
UConn,2023,3,229,358,12,0.25,-129
UFTL,2021,0,18,226,4,0.0,-208
UFTL,2022,0,8,120,3,0.0,-112
UFTL,2023,0,0,49,1,0.0,-49
UL Monroe,2015,2,273,475,13,0.15384615384615385,-202
UL Monroe,2016,4,280,469,12,0.3333333333333333,-189
UL Monroe,2017,4,407,492,12,0.3333333333333333,-85
UL Monroe,2018,6,319,381,12,0.5,-62
UL Monroe,2019,5,379,464,12,0.4166666666666667,-85
UL Monroe,2020,0,163,420,10,0.0,-257
UL Monroe,2021,4,251,402,12,0.3333333333333333,-151
UL Monroe,2022,4,268,413,12,0.3333333333333333,-145
UL Monroe,2023,2,208,419,12,0.16666666666666666,-211
UMass Dartmouth,2022,9,443,251,11,0.8181818181818182,192
UMass Dartmouth,2023,9,367,130,10,0.9,237
UNC Pembroke,2020,2,130,110,4,0.5,20
UNC Pembroke,2021,5,240,282,10,0.5,-42
UNC Pembroke,2022,5,276,318,11,0.45454545454545453,-42
UNC Pembroke,2023,7,404,189,11,0.6363636363636364,215
UNLV,2015,3,343,404,12,0.25,-61
UNLV,2016,4,379,441,12,0.3333333333333333,-62
UNLV,2017,5,346,381,12,0.4166666666666667,-35
UNLV,2018,4,345,447,12,0.3333333333333333,-102
UNLV,2019,4,290,396,12,0.3333333333333333,-106
UNLV,2020,0,104,228,6,0.0,-124
UNLV,2021,2,249,394,12,0.16666666666666666,-145
UNLV,2022,5,316,342,12,0.4166666666666667,-26
UNLV,2023,9,482,400,14,0.6428571428571429,82
USC,2015,8,475,360,14,0.5714285714285714,115
USC,2016,10,447,315,13,0.7692307692307693,132
USC,2017,11,456,366,14,0.7857142857142857,90
USC,2018,5,313,324,12,0.4166666666666667,-11
USC,2019,8,422,382,13,0.6153846153846154,40
USC,2020,5,200,156,6,0.8333333333333334,44
USC,2021,4,344,381,12,0.3333333333333333,-37
USC,2022,11,579,409,14,0.7857142857142857,170
USC,2023,8,544,447,13,0.6153846153846154,97
UT Martin,2015,7,390,370,11,0.6363636363636364,20
UT Martin,2016,7,387,288,12,0.5833333333333334,99
UT Martin,2017,6,216,157,11,0.5454545454545454,59
UT Martin,2018,2,318,378,11,0.18181818181818182,-60
UT Martin,2019,7,307,299,12,0.5833333333333334,8
UT Martin,2020,3,175,154,7,0.42857142857142855,21
UT Martin,2021,10,390,325,13,0.7692307692307693,65
UT Martin,2022,7,382,331,11,0.6363636363636364,51
UT Martin,2023,8,349,264,11,0.7272727272727273,85
UT Permian Basin,2021,5,287,261,10,0.5,26
UT Permian Basin,2022,5,265,303,11,0.45454545454545453,-38
UT Permian Basin,2023,10,509,207,12,0.8333333333333334,302
UTEP,2015,5,248,395,12,0.4166666666666667,-147
UTEP,2016,4,316,419,12,0.3333333333333333,-103
UTEP,2017,0,141,441,12,0.0,-300
UTEP,2018,1,212,393,12,0.08333333333333333,-181
UTEP,2019,1,235,431,12,0.08333333333333333,-196
UTEP,2020,3,184,248,8,0.375,-64
UTEP,2021,7,326,328,13,0.5384615384615384,-2
UTEP,2022,5,293,324,12,0.4166666666666667,-31
UTEP,2023,3,239,342,12,0.25,-103
UTSA,2015,3,271,405,12,0.25,-134
UTSA,2016,6,379,363,13,0.46153846153846156,16
UTSA,2017,6,259,187,11,0.5454545454545454,72
UTSA,2018,3,170,374,12,0.25,-204
UTSA,2019,4,244,407,12,0.3333333333333333,-163
UTSA,2020,7,339,308,12,0.5833333333333334,31
UTSA,2021,12,516,345,14,0.8571428571428571,171
UTSA,2022,11,515,363,14,0.7857142857142857,152
UTSA,2023,9,415,313,13,0.6923076923076923,102
UVA Wise,2019,0,14,31,1,0.0,-17
UVA Wise,2020,1,101,98,3,0.3333333333333333,3
UVA Wise,2021,5,283,313,11,0.45454545454545453,-30
UVA Wise,2022,2,197,327,11,0.18181818181818182,-130
UVA Wise,2023,2,182,386,11,0.18181818181818182,-204
Union (NY),2022,6,341,162,10,0.6,179
Union (NY),2023,10,393,137,12,0.8333333333333334,256
Union College,2019,0,7,44,1,0.0,-37
Union College,2023,0,0,48,1,0.0,-48
University Of Charleston (WV),2019,1,19,13,1,1.0,6
University Of Charleston (WV),2020,3,126,34,3,1.0,92
University Of Charleston (WV),2021,8,361,143,10,0.8,218
University Of Charleston (WV),2022,6,439,359,11,0.5454545454545454,80
University Of Charleston (WV),2023,10,528,287,13,0.7692307692307693,241
University of Mary,2021,4,382,400,11,0.36363636363636365,-18
University of Mary,2022,2,254,357,11,0.18181818181818182,-103
University of Mary,2023,2,185,386,11,0.18181818181818182,-201
University of Mount Union,2015,1,49,35,1,1.0,14
University of Mount Union,2017,1,12,0,1,1.0,12
University of Mount Union,2018,0,16,24,1,0.0,-8
University of Mount Union,2020,3,123,45,3,1.0,78
University of Mount Union,2022,14,653,151,15,0.9333333333333333,502
University of Mount Union,2023,11,585,99,12,0.9166666666666666,486
University of Rochester (NY),2022,3,150,278,10,0.3,-128
University of Rochester (NY),2023,5,238,234,10,0.5,4
Upper Iowa University,2021,1,193,393,11,0.09090909090909091,-200
Upper Iowa University,2022,1,150,422,11,0.09090909090909091,-272
Upper Iowa University,2023,3,264,331,11,0.2727272727272727,-67
Ursinus,2022,8,411,181,10,0.8,230
Ursinus,2023,7,319,197,10,0.7,122
Utah,2015,10,398,290,13,0.7692307692307693,108
Utah,2016,9,388,311,13,0.6923076923076923,77
Utah,2017,7,384,301,13,0.5384615384615384,83
Utah,2018,9,393,272,14,0.6428571428571429,121
Utah,2019,11,452,210,14,0.7857142857142857,242
Utah,2020,3,151,130,5,0.6,21
Utah,2021,10,506,316,14,0.7142857142857143,190
Utah,2022,10,541,300,14,0.7142857142857143,241
Utah,2023,8,301,251,13,0.6153846153846154,50
Utah State,2015,6,377,347,13,0.46153846153846156,30
Utah State,2016,3,287,352,12,0.25,-65
Utah State,2017,6,392,350,13,0.46153846153846156,42
Utah State,2018,11,618,289,13,0.8461538461538461,329
Utah State,2019,7,380,399,13,0.5384615384615384,-19
Utah State,2020,1,93,211,6,0.16666666666666666,-118
Utah State,2021,11,456,342,14,0.7857142857142857,114
Utah State,2022,6,289,405,13,0.46153846153846156,-116
Utah State,2023,6,431,451,13,0.46153846153846156,-20
Utah Tech,2020,2,157,124,5,0.4,33
Utah Tech,2021,1,204,436,11,0.09090909090909091,-232
Utah Tech,2022,4,312,386,11,0.36363636363636365,-74
Utah Tech,2023,2,254,416,11,0.18181818181818182,-162
Utica,2020,1,40,34,2,0.5,6
Utica,2022,10,375,273,12,0.8333333333333334,102
Utica,2023,8,244,186,10,0.8,58
VMI,2015,2,254,385,11,0.18181818181818182,-131
VMI,2016,3,224,305,11,0.2727272727272727,-81
VMI,2017,0,88,408,11,0.0,-320
VMI,2018,1,257,530,11,0.09090909090909091,-273
VMI,2019,5,370,453,12,0.4166666666666667,-83
VMI,2020,6,234,174,8,0.75,60
VMI,2021,6,344,365,11,0.5454545454545454,-21
VMI,2022,1,177,399,11,0.09090909090909091,-222
VMI,2023,5,160,260,11,0.45454545454545453,-100
Valdosta State,2018,1,49,47,1,1.0,2
Valdosta State,2021,12,579,318,14,0.8571428571428571,261
Valdosta State,2022,5,403,407,11,0.45454545454545453,-4
Valdosta State,2023,12,516,340,14,0.8571428571428571,176
Valley City State,2023,0,14,31,1,0.0,-17
Valparaiso,2015,1,159,432,10,0.1,-273
Valparaiso,2016,4,253,366,11,0.36363636363636365,-113
Valparaiso,2017,6,330,313,11,0.5454545454545454,17
Valparaiso,2018,2,290,392,11,0.18181818181818182,-102
Valparaiso,2019,1,187,384,12,0.08333333333333333,-197
Valparaiso,2020,4,112,110,6,0.6666666666666666,2
Valparaiso,2021,4,298,346,11,0.36363636363636365,-48
Valparaiso,2022,5,267,361,12,0.4166666666666667,-94
Valparaiso,2023,3,195,273,11,0.2727272727272727,-78
Vanderbilt,2015,4,182,252,12,0.3333333333333333,-70
Vanderbilt,2016,6,299,312,13,0.46153846153846156,-13
Vanderbilt,2017,5,295,376,12,0.4166666666666667,-81
Vanderbilt,2018,6,370,346,13,0.46153846153846156,24
Vanderbilt,2019,3,198,381,12,0.25,-183
Vanderbilt,2020,0,133,336,9,0.0,-203
Vanderbilt,2021,2,189,430,12,0.16666666666666666,-241
Vanderbilt,2022,5,295,432,12,0.4166666666666667,-137
Vanderbilt,2023,2,274,434,12,0.16666666666666666,-160
Villanova,2015,6,231,202,11,0.5454545454545454,29
Villanova,2016,9,317,195,13,0.6923076923076923,122
Villanova,2017,5,231,177,11,0.45454545454545453,54
Villanova,2018,5,275,257,11,0.45454545454545453,18
Villanova,2019,9,485,339,13,0.6923076923076923,146
Villanova,2020,2,117,97,4,0.5,20
Villanova,2021,10,391,217,13,0.7692307692307693,174
Villanova,2022,6,289,313,11,0.5454545454545454,-24
Villanova,2023,10,415,245,13,0.7692307692307693,170
Virginia,2015,4,309,386,12,0.3333333333333333,-77
Virginia,2016,2,270,405,12,0.16666666666666666,-135
Virginia,2017,6,293,369,13,0.46153846153846156,-76
Virginia,2018,8,370,261,13,0.6153846153846154,109
Virginia,2019,9,449,380,14,0.6428571428571429,69
Virginia,2020,5,307,296,10,0.5,11
Virginia,2021,6,415,382,12,0.5,33
Virginia,2022,3,170,240,10,0.3,-70
Virginia,2023,3,279,405,12,0.25,-126
Virginia St,2017,1,14,10,1,1.0,4
Virginia St,2018,0,32,56,2,0.0,-24
Virginia St,2019,0,21,44,1,0.0,-23
Virginia St,2021,3,206,214,9,0.3333333333333333,-8
Virginia St,2022,6,305,233,10,0.6,72
Virginia St,2023,8,374,183,10,0.8,191
Virginia Tech,2015,7,403,342,13,0.5384615384615384,61
Virginia Tech,2016,10,490,319,14,0.7142857142857143,171
Virginia Tech,2017,9,366,192,13,0.6923076923076923,174
Virginia Tech,2018,6,388,403,13,0.46153846153846156,-15
Virginia Tech,2019,8,401,321,13,0.6153846153846154,80
Virginia Tech,2020,5,342,353,11,0.45454545454545453,-11
Virginia Tech,2021,6,308,329,13,0.46153846153846156,-21
Virginia Tech,2022,3,212,272,11,0.2727272727272727,-60
Virginia Tech,2023,7,384,311,13,0.5384615384615384,73
Virginia Union,2015,0,9,13,1,0.0,-4
Virginia Union,2019,1,36,17,1,1.0,19
Virginia Union,2021,6,275,219,10,0.6,56
Virginia Union,2022,9,460,187,11,0.8181818181818182,273
Virginia Union,2023,10,426,166,12,0.8333333333333334,260
Virginia University Of Lynchburg,2016,0,12,72,1,0.0,-60
Virginia University Of Lynchburg,2017,0,5,113,2,0.0,-108
Virginia University Of Lynchburg,2018,0,57,229,4,0.0,-172
Virginia University Of Lynchburg,2019,0,83,345,7,0.0,-262
Virginia University Of Lynchburg,2021,0,80,478,9,0.0,-398
Virginia University Of Lynchburg,2022,0,77,417,9,0.0,-340
Virginia University Of Lynchburg,2023,1,127,460,10,0.1,-333
Wabash College,2022,6,376,314,9,0.6666666666666666,62
Wabash College,2023,7,410,241,10,0.7,169
Wagner,2015,1,157,397,11,0.09090909090909091,-240
Wagner,2016,6,287,232,11,0.5454545454545454,55
Wagner,2017,4,234,304,11,0.36363636363636365,-70
Wagner,2018,4,308,437,11,0.36363636363636365,-129
Wagner,2019,1,165,319,12,0.08333333333333333,-154
Wagner,2020,0,7,44,2,0.0,-37
Wagner,2021,0,141,424,11,0.0,-283
Wagner,2022,1,151,463,11,0.09090909090909091,-312
Wagner,2023,4,192,328,11,0.36363636363636365,-136
Wake Forest,2015,3,209,295,12,0.25,-86
Wake Forest,2016,7,265,288,13,0.5384615384615384,-23
Wake Forest,2017,8,459,368,13,0.6153846153846154,91
Wake Forest,2018,7,427,433,13,0.5384615384615384,-6
Wake Forest,2019,8,414,378,13,0.6153846153846154,36
Wake Forest,2020,4,324,295,9,0.4444444444444444,29
Wake Forest,2021,11,574,404,14,0.7857142857142857,170
Wake Forest,2022,8,469,368,13,0.6153846153846154,101
Wake Forest,2023,4,243,326,12,0.3333333333333333,-83
Waldorf College,2018,0,34,63,1,0.0,-29
Waldorf College,2022,0,3,69,1,0.0,-66
Walsh,2017,0,37,113,2,0.0,-76
Walsh,2019,0,3,44,1,0.0,-41
Walsh,2020,1,59,118,5,0.2,-59
Walsh,2021,2,127,290,9,0.2222222222222222,-163
Walsh,2022,1,111,293,10,0.1,-182
Walsh,2023,3,163,258,11,0.2727272727272727,-95
Warner University,2015,0,23,87,2,0.0,-64
Warner University,2016,0,15,30,1,0.0,-15
Warner University,2021,0,14,54,1,0.0,-40
Warner University,2022,0,3,150,2,0.0,-147
Warner University,2023,1,29,23,1,1.0,6
Wartburg,2022,13,568,138,14,0.9285714285714286,430
Wartburg,2023,13,580,185,14,0.9285714285714286,395
Washburn,2021,9,390,263,12,0.75,127
Washburn,2022,7,364,258,11,0.6363636363636364,106
Washburn,2023,2,258,396,11,0.18181818181818182,-138
Washington,2015,7,398,244,13,0.5384615384615384,154
Washington,2016,12,585,248,14,0.8571428571428571,337
Washington,2017,10,471,209,13,0.7692307692307693,262
Washington,2018,10,369,229,14,0.7142857142857143,140
Washington,2019,8,416,252,13,0.6153846153846154,164
Washington,2020,3,121,100,4,0.75,21
Washington,2021,4,258,272,12,0.3333333333333333,-14
Washington,2022,11,516,336,13,0.8461538461538461,180
Washington,2023,14,540,372,15,0.9333333333333333,168
Washington & Jefferson,2020,3,148,47,4,0.75,101
Washington & Jefferson,2022,8,379,122,10,0.8,257
Washington & Jefferson,2023,8,386,186,10,0.8,200
Washington State,2015,9,409,360,13,0.6923076923076923,49
Washington State,2016,8,496,343,13,0.6153846153846154,153
Washington State,2017,9,394,335,13,0.6923076923076923,59
Washington State,2018,11,488,303,13,0.8461538461538461,185
Washington State,2019,6,491,408,13,0.46153846153846156,83
Washington State,2020,1,108,154,4,0.25,-46
Washington State,2021,7,362,315,13,0.5384615384615384,47
Washington State,2022,7,339,298,13,0.5384615384615384,41
Washington State,2023,5,380,337,12,0.4166666666666667,43
Washington University (St. Louis),2022,8,436,179,10,0.8,257
Washington University (St. Louis),2023,7,380,207,10,0.7,173
Washington and Lee,2022,5,247,144,10,0.5,103
Washington and Lee,2023,8,307,206,10,0.8,101
Wayland Baptist,2022,0,14,79,1,0.0,-65
Wayland Baptist,2023,0,7,27,1,0.0,-20
Wayne State (MI),2021,2,265,361,11,0.18181818181818182,-96
Wayne State (MI),2022,1,219,362,10,0.1,-143
Wayne State (MI),2023,3,191,354,11,0.2727272727272727,-163
Wayne State (NE),2021,7,358,287,11,0.6363636363636364,71
Wayne State (NE),2022,9,351,252,12,0.75,99
Wayne State (NE),2023,8,355,253,11,0.7272727272727273,102
Waynesburg,2020,0,47,234,5,0.0,-187
Waynesburg,2022,4,249,311,10,0.4,-62
Waynesburg,2023,2,223,306,10,0.2,-83
Webber International,2015,0,13,42,1,0.0,-29
Webber International,2023,0,28,38,1,0.0,-10
Weber State,2015,6,247,270,11,0.5454545454545454,-23
Weber State,2016,7,312,360,12,0.5833333333333334,-48
Weber State,2017,11,472,246,14,0.7857142857142857,226
Weber State,2018,10,362,275,13,0.7692307692307693,87
Weber State,2019,11,417,312,15,0.7333333333333333,105
Weber State,2020,5,165,122,6,0.8333333333333334,43
Weber State,2021,6,344,215,11,0.5454545454545454,129
Weber State,2022,10,457,265,13,0.7692307692307693,192
Weber State,2023,6,265,265,11,0.5454545454545454,0
Wesley College,2020,2,73,52,3,0.6666666666666666,21
Wesleyan University (CT),2022,5,210,150,8,0.625,60
Wesleyan University (CT),2023,6,219,238,9,0.6666666666666666,-19
West Alabama,2016,0,24,30,1,0.0,-6
West Alabama,2017,0,41,49,1,0.0,-8
West Alabama,2020,2,63,45,2,1.0,18
West Alabama,2021,6,303,235,10,0.6,68
West Alabama,2022,5,252,219,11,0.45454545454545453,33
West Alabama,2023,5,156,193,10,0.5,-37
West Chester,2021,6,348,287,11,0.5454545454545454,61
West Chester,2022,7,275,243,11,0.6363636363636364,32
West Chester,2023,6,286,319,11,0.5454545454545454,-33
West Florida,2017,0,27,37,1,0.0,-10
West Florida,2018,1,24,19,1,1.0,5
West Florida,2019,1,48,40,1,1.0,8
West Florida,2021,8,458,250,10,0.8,208
West Florida,2022,12,583,334,14,0.8571428571428571,249
West Florida,2023,8,385,216,12,0.6666666666666666,169
West Georgia,2021,9,435,246,12,0.75,189
West Georgia,2022,8,404,239,10,0.8,165
West Georgia,2023,6,276,307,10,0.6,-31
West Liberty,2020,2,101,132,4,0.5,-31
West Liberty,2021,4,227,290,11,0.36363636363636365,-63
West Liberty,2022,4,239,326,11,0.36363636363636365,-87
West Liberty,2023,4,254,293,11,0.36363636363636365,-39
West Texas A&M,2020,0,6,34,1,0.0,-28
West Texas A&M,2021,7,377,216,11,0.6363636363636364,161
West Texas A&M,2022,5,302,297,11,0.45454545454545453,5
West Texas A&M,2023,3,254,260,10,0.3,-6
West Virginia,2015,8,442,320,13,0.6153846153846154,122
West Virginia,2016,10,405,312,13,0.7692307692307693,93
West Virginia,2017,7,449,409,13,0.5384615384615384,40
West Virginia,2018,8,483,326,12,0.6666666666666666,157
West Virginia,2019,5,247,346,12,0.4166666666666667,-99
West Virginia,2020,6,265,205,10,0.6,60
West Virginia,2021,6,328,310,13,0.46153846153846156,18
West Virginia,2022,5,367,395,12,0.4166666666666667,-28
West Virginia,2023,9,409,340,13,0.6923076923076923,69
West Virginia State,2019,0,10,56,1,0.0,-46
West Virginia State,2020,2,106,127,4,0.5,-21
West Virginia State,2021,6,296,275,11,0.5454545454545454,21
West Virginia State,2022,7,353,306,11,0.6363636363636364,47
West Virginia State,2023,4,301,297,11,0.36363636363636365,4
West Virginia Wesleyan,2016,0,7,38,1,0.0,-31
West Virginia Wesleyan,2017,0,13,38,1,0.0,-25
West Virginia Wesleyan,2018,0,3,59,1,0.0,-56
West Virginia Wesleyan,2019,0,0,41,1,0.0,-41
West Virginia Wesleyan,2020,0,27,90,2,0.0,-63
West Virginia Wesleyan,2021,0,98,424,10,0.0,-326
West Virginia Wesleyan,2022,1,154,441,11,0.09090909090909091,-287
West Virginia Wesleyan,2023,0,89,535,11,0.0,-446
Western Carolina,2015,7,301,304,11,0.6363636363636364,-3
Western Carolina,2016,2,265,396,11,0.18181818181818182,-131
Western Carolina,2017,7,389,325,12,0.5833333333333334,64
Western Carolina,2018,3,347,451,11,0.2727272727272727,-104
Western Carolina,2019,3,217,465,12,0.25,-248
Western Carolina,2020,1,147,359,9,0.1111111111111111,-212
Western Carolina,2021,4,356,454,11,0.36363636363636365,-98
Western Carolina,2022,6,351,351,11,0.5454545454545454,0
Western Carolina,2023,7,399,298,11,0.6363636363636364,101
Western Colorado,2015,0,34,42,1,0.0,-8
Western Colorado,2018,0,10,45,1,0.0,-35
Western Colorado,2019,0,13,38,1,0.0,-25
Western Colorado,2020,0,7,64,1,0.0,-57
Western Colorado,2021,10,416,194,12,0.8333333333333334,222
Western Colorado,2022,7,347,282,11,0.6363636363636364,65
Western Colorado,2023,10,433,196,12,0.8333333333333334,237
Western Connecticut St,2022,7,275,251,10,0.7,24
Western Connecticut St,2023,7,428,234,10,0.7,194
Western Illinois,2015,7,327,386,13,0.5384615384615384,-59
Western Illinois,2016,6,319,346,11,0.5454545454545454,-27
Western Illinois,2017,8,410,266,12,0.6666666666666666,144
Western Illinois,2018,5,263,286,11,0.45454545454545453,-23
Western Illinois,2019,1,224,443,12,0.08333333333333333,-219
Western Illinois,2020,1,120,197,6,0.16666666666666666,-77
Western Illinois,2021,2,268,427,11,0.18181818181818182,-159
Western Illinois,2022,0,150,426,11,0.0,-276
Western Illinois,2023,0,138,509,11,0.0,-371
Western Kentucky,2015,12,620,363,14,0.8571428571428571,257
Western Kentucky,2016,11,637,344,14,0.7857142857142857,293
Western Kentucky,2017,6,331,349,13,0.46153846153846156,-18
Western Kentucky,2018,3,253,334,12,0.25,-81
Western Kentucky,2019,9,330,261,13,0.6923076923076923,69
Western Kentucky,2020,5,228,304,12,0.4166666666666667,-76
Western Kentucky,2021,9,619,411,14,0.6428571428571429,208
Western Kentucky,2022,9,510,328,14,0.6428571428571429,182
Western Kentucky,2023,8,396,373,13,0.6153846153846154,23
Western Michigan,2015,8,468,368,13,0.6153846153846154,100
Western Michigan,2016,13,582,277,14,0.9285714285714286,305
Western Michigan,2017,6,407,348,12,0.5,59
Western Michigan,2018,7,416,449,13,0.5384615384615384,-33
Western Michigan,2019,7,430,337,13,0.5384615384615384,93
Western Michigan,2020,4,250,205,6,0.6666666666666666,45
Western Michigan,2021,8,422,367,13,0.6153846153846154,55
Western Michigan,2022,5,228,289,12,0.4166666666666667,-61
Western Michigan,2023,4,284,381,12,0.3333333333333333,-97
Western New England,2019,0,28,59,1,0.0,-31
Western New England,2022,4,247,217,10,0.4,30
Western New England,2023,7,343,187,10,0.7,156
Western New Mexico,2015,0,21,45,1,0.0,-24
Western New Mexico,2016,0,0,27,1,0.0,-27
Western New Mexico,2017,0,20,34,1,0.0,-14
Western New Mexico,2018,0,19,94,2,0.0,-75
Western New Mexico,2019,0,21,55,1,0.0,-34
Western New Mexico,2021,1,218,470,11,0.09090909090909091,-252
Western New Mexico,2022,6,280,327,11,0.5454545454545454,-47
Western New Mexico,2023,2,190,439,10,0.2,-249
Western Oregon,2015,0,0,31,1,0.0,-31
Western Oregon,2016,0,0,55,1,0.0,-55
Western Oregon,2017,0,6,37,1,0.0,-31
Western Oregon,2021,4,224,294,10,0.4,-70
Western Oregon,2022,6,298,247,11,0.5454545454545454,51
Western Oregon,2023,3,216,323,11,0.2727272727272727,-107
Westfield State,2022,2,197,261,10,0.2,-64
Westfield State,2023,3,173,237,10,0.3,-64
Westminster (PA),2020,5,177,101,5,1.0,76
Westminster (PA),2022,7,264,102,10,0.7,162
Westminster (PA),2023,6,208,202,10,0.6,6
Westminster College (MO),2020,2,64,70,3,0.6666666666666666,-6
Westminster College (MO),2022,1,71,328,10,0.1,-257
Westminster College (MO),2023,1,103,301,9,0.1111111111111111,-198
Wheaton,2022,8,469,204,11,0.7272727272727273,265
Wheaton,2023,10,552,294,12,0.8333333333333334,258
Wheeling,2020,2,103,107,4,0.5,-4
Wheeling,2021,5,242,239,11,0.45454545454545453,3
Wheeling,2022,7,336,279,11,0.6363636363636364,57
Wheeling,2023,5,286,260,11,0.45454545454545453,26
Whittier,2022,0,66,427,9,0.0,-361
Whitworth,2020,4,167,51,4,1.0,116
Whitworth,2022,6,295,199,10,0.6,96
Whitworth,2023,10,449,234,11,0.9090909090909091,215
Widener,2022,3,201,302,10,0.3,-101
Widener,2023,7,318,201,10,0.7,117
Wilkes,2022,7,297,183,10,0.7,114
Wilkes,2023,4,300,261,10,0.4,39
Willamette,2022,2,139,365,10,0.2,-226
Willamette,2023,1,116,529,10,0.1,-413
William & Mary,2015,9,402,295,13,0.6923076923076923,107
William & Mary,2016,5,243,259,11,0.45454545454545453,-16
William & Mary,2017,2,165,263,11,0.18181818181818182,-98
William & Mary,2018,4,136,262,10,0.4,-126
William & Mary,2019,5,303,338,12,0.4166666666666667,-35
William & Mary,2020,1,55,69,3,0.3333333333333333,-14
William & Mary,2021,6,245,243,11,0.5454545454545454,2
William & Mary,2022,11,428,293,13,0.8461538461538461,135
William & Mary,2023,6,239,204,11,0.5454545454545454,35
William Jewell,2015,0,30,44,1,0.0,-14
William Jewell,2020,0,93,138,3,0.0,-45
William Jewell,2021,0,116,409,9,0.0,-293
William Jewell,2022,2,208,414,11,0.18181818181818182,-206
William Jewell,2023,2,225,409,10,0.2,-184
William Paterson,2020,0,0,28,1,0.0,-28
William Paterson,2022,5,147,188,10,0.5,-41
William Paterson,2023,2,190,262,10,0.2,-72
Williams,2022,3,160,188,8,0.375,-28
Williams,2023,3,162,191,9,0.3333333333333333,-29
Wilmington (OH),2020,2,81,104,4,0.5,-23
Wilmington (OH),2022,3,166,358,10,0.3,-192
Wilmington (OH),2023,3,318,473,10,0.3,-155
Wilson,2020,0,72,149,4,0.0,-77
Wilson,2021,6,324,285,11,0.5454545454545454,39
Wilson,2022,4,246,279,11,0.36363636363636365,-33
Wilson,2023,6,297,266,11,0.5454545454545454,31
Wingate,2020,2,118,98,4,0.5,20
Wingate,2021,7,308,221,10,0.7,87
Wingate,2022,11,347,178,14,0.7857142857142857,169
Wingate,2023,8,298,156,11,0.7272727272727273,142
Winona State,2021,7,333,266,11,0.6363636363636364,67
Winona State,2022,8,324,233,12,0.6666666666666666,91
Winona State,2023,5,279,298,11,0.45454545454545453,-19
Winston-Salem,2021,3,145,200,9,0.3333333333333333,-55
Winston-Salem,2022,3,154,188,10,0.3,-34
Winston-Salem,2023,4,267,245,10,0.4,22
Wisconsin,2015,10,348,178,13,0.7692307692307693,170
Wisconsin,2016,11,397,218,14,0.7857142857142857,179
Wisconsin,2017,13,473,195,14,0.9285714285714286,278
Wisconsin,2018,8,386,294,13,0.6153846153846154,92
Wisconsin,2019,10,477,237,14,0.7142857142857143,240
Wisconsin,2020,4,176,122,7,0.5714285714285714,54
Wisconsin,2021,9,330,210,13,0.6923076923076923,120
Wisconsin,2022,7,342,263,13,0.5384615384615384,79
Wisconsin,2023,7,305,262,13,0.5384615384615384,43
Wisconsin-Eau Claire,2022,2,205,443,10,0.2,-238
Wisconsin-Eau Claire,2023,2,124,400,10,0.2,-276
Wisconsin-Lacrosse,2021,0,24,45,1,0.0,-21
Wisconsin-Lacrosse,2022,9,378,196,11,0.8181818181818182,182
Wisconsin-Lacrosse,2023,11,511,302,13,0.8461538461538461,209
Wisconsin-Lutheran,2020,1,80,115,3,0.3333333333333333,-35
Wisconsin-Lutheran,2022,4,245,357,10,0.4,-112
Wisconsin-Lutheran,2023,4,226,326,10,0.4,-100
Wisconsin-Oshkosh,2016,0,7,10,1,0.0,-3
Wisconsin-Oshkosh,2021,1,28,10,1,1.0,18
Wisconsin-Oshkosh,2022,6,336,153,10,0.6,183
Wisconsin-Oshkosh,2023,6,372,270,10,0.6,102
Wisconsin-Platteville,2022,5,169,216,10,0.5,-47
Wisconsin-Platteville,2023,6,352,204,10,0.6,148
Wisconsin-River Falls,2022,6,399,206,10,0.6,193
Wisconsin-River Falls,2023,7,430,197,10,0.7,233
Wisconsin-Stevens Pt,2022,1,128,435,10,0.1,-307
Wisconsin-Stevens Pt,2023,1,137,491,10,0.1,-354
Wisconsin-Stout,2022,5,322,221,10,0.5,101
Wisconsin-Stout,2023,4,334,285,10,0.4,49
Wisconsin-Whitewater,2019,0,14,41,1,0.0,-27
Wisconsin-Whitewater,2022,8,324,203,11,0.7272727272727273,121
Wisconsin-Whitewater,2023,11,500,267,13,0.8461538461538461,233
Wittenberg,2022,5,360,240,10,0.5,120
Wittenberg,2023,7,375,275,10,0.7,100
Wofford,2015,5,284,305,11,0.45454545454545453,-21
Wofford,2016,10,375,239,14,0.7142857142857143,136
Wofford,2017,10,334,291,13,0.7692307692307693,43
Wofford,2018,9,385,247,13,0.6923076923076923,138
Wofford,2019,8,387,265,12,0.6666666666666666,122
Wofford,2020,1,130,139,5,0.2,-9
Wofford,2021,1,225,380,11,0.09090909090909091,-155
Wofford,2022,3,220,350,11,0.2727272727272727,-130
Wofford,2023,2,152,278,11,0.18181818181818182,-126
Wooster,2020,0,38,52,1,0.0,-14
Wooster,2022,6,308,320,10,0.6,-12
Wooster,2023,4,337,354,10,0.4,-17
Worcester Polytechnic Institute,2022,4,174,252,10,0.4,-78
Worcester Polytechnic Institute,2023,3,231,266,10,0.3,-35
Worcester St,2022,1,211,391,10,0.1,-180
Worcester St,2023,1,100,400,10,0.1,-300
Wyoming,2015,2,228,408,12,0.16666666666666666,-180
Wyoming,2016,8,503,477,14,0.5714285714285714,26
Wyoming,2017,8,305,228,13,0.6153846153846154,77
Wyoming,2018,6,248,264,12,0.5,-16
Wyoming,2019,8,330,231,13,0.6153846153846154,99
Wyoming,2020,2,159,126,6,0.3333333333333333,33
Wyoming,2021,7,330,308,13,0.5384615384615384,22
Wyoming,2022,7,276,311,13,0.5384615384615384,-35
Wyoming,2023,9,329,290,13,0.6923076923076923,39
Yale,2015,6,235,242,10,0.6,-7
Yale,2016,3,203,339,10,0.3,-136
Yale,2017,9,345,156,10,0.9,189
Yale,2018,5,295,285,10,0.5,10
Yale,2019,9,387,262,10,0.9,125
Yale,2021,5,299,247,10,0.5,52
Yale,2022,8,305,195,10,0.8,110
Yale,2023,7,299,199,10,0.7,100
Youngstown State,2015,5,323,254,11,0.45454545454545453,69
Youngstown State,2016,12,442,319,16,0.75,123
Youngstown State,2017,6,327,210,11,0.5454545454545454,117
Youngstown State,2018,4,254,299,11,0.36363636363636365,-45
Youngstown State,2019,6,365,321,12,0.5,44
Youngstown State,2020,1,108,153,7,0.14285714285714285,-45
Youngstown State,2021,3,247,354,10,0.3,-107
Youngstown State,2022,7,314,279,11,0.6363636363636364,35
Youngstown State,2023,8,409,323,13,0.6153846153846154,86
